fixation			å›ºå®š->ç”¨äºå¿ƒç†å­¦ï¼Œè¿·æ‹ï¼Œç™–å¥½. He's got this fixation with cleanliness. ä»–æœ‰æ´ç™–ã€‚
predicament		çŠ¶æ€ï¼Œçª˜å†µå›°å¢ƒã€‚æ¥è‡ªpredicté¢„è¨€é¢„æµ‹ã€‚  Believing in some sort of purpose is what keeps me going, what keeps me banging my head against the thick wall of my predicament. ç›¸ä¿¡æœ‰å…¶ç›®çš„å­˜åœ¨ï¼Œä¹ƒæ˜¯æˆ‘ä¸€æ¬¡æ¬¡åœ¨å›°å¢ƒçš„å—å¢™ä¸Šæ’å¾—å¤´ç ´è¡€æµå´ä¾ç„¶ä¸çŸ¥é€€ç¼©çš„åŸå› ã€‚
chirp			n/vå½å½å–³å–³å«(æ‹Ÿå£°è¯)
*mug			é©¬å…‹æ¯ã€‚
smite			n/væ‰“å‡»ï¼›ä½¿ç¥é­‚é¢ å€’ã€‚I think someone's smitten with you, Pinkie.  æˆ‘æƒ³æœ‰è°è¿·ä¸Šä½ äº†ï¼Œèçªã€‚
*custard			è›‹å¥¶æ²¹ã€‚è›‹å¥¶æ²™å¸ã€‚custæ¥è‡ªcrusté¢åŒ…å±‘ã€‚
*strudel			ä»¥æœå®æˆ–å¹²é…ªä¸ºé¦…è€Œçƒ¤æˆçš„ç‚¹å¿ƒã€‚
relinquish			æ”¾å¼ƒï¼Œæ”¾æ‰‹ã€‚ "desert,abandon,ditch"  They will never voluntarily relinquish their independence.  ä»–ä»¬ç»å¯¹ä¸ä¼šè‡ªåŠ¨æ”¾å¼ƒç‹¬ç«‹.
resolve			nå†³å¿ƒï¼Œå†³å®šã€‚vä¸‹å†³å®š->è§£å†³->åˆ†è§£è§£ä½“(dissove)/(ç‚ç—‡)æ¶ˆé€€  My days now are filled with tranquility, purpose, and resolve. 
*damnation 		n. ç½šå…¥åœ°ç‹±ï¼Œé­å¤©è°´ã€‚
merit 			nä¼˜ç‚¹ä»·å€¼ï¼Œvå€¼å¾—ã€‚   what is the power of damnation without a slice of hope to merit its potency?     æ¯•ç«Ÿï¼Œå¦‚æœæ²¡æœ‰ä¸€ä¸å¸Œæœ›æ¥(åå‘)è¯æ˜å®ƒçš„ä½œç”¨(potency)ï¼Œè¯…å’’çš„åŠ›é‡åˆå¦‚ä½•ä½“ç°å‘¢ï¼Ÿ
*anchor-age 		né”šåœ°ã€‚æ¥è‡ªanchoré”šã€‚  Every breath and song and sob holds anchorage in my throat and mine alone.  æ¯ä¸€æ¬¡å‘¼å¸ï¼Œæ¯ä¸€é¦–æ­Œæ›²ï¼Œæ¯ä¸€å£°å“­æ³£ï¼Œéƒ½å‘è‡ªäºæˆ‘çš„å–‰ä¸­ï¼Œåªå‘è‡ªäºæˆ‘è‡ªå·±ã€‚	
desolate			è’å‡‰çš„ã€‚deslation--nåºŸå¼ƒã€‚de-å‘ä¸‹ï¼Œå¼ºè°ƒã€‚sol-å•ç‹¬çš„ã€‚
surly 			ä¹–æˆ¾çš„æ— ç†çš„å‚²æ…¢çš„é˜´æ²‰çš„æ•Œæ„çš„ã€‚æ”¹å†™è‡ªsir (è¯»éŸ³äº¦å¦‚æ˜¯)ï¼Œå…ˆç”Ÿï¼Œé¢†å¯¼ï¼Œæ¯”å–»ç”¨æ³•ã€‚
*sorcerer 	['sÉ”rsÉ™rÉš]		å·«å¸ˆï¼Œç”·å·«ã€‚æ¥è‡ªsorceryï¼Œå·«æœ¯ã€‚æ¥è‡ªsors(å‘½è¿ï¼ŒæŠ½ç­¾æŠ“é˜„)-ery
*get-together		[å£]èšä¼šã€‚
phantom 			å¹½çµã€‚  phantom limbå¹»è‚¢
specter=spectre=spectrum	å¹½çµã€‚ (spectrumè¿˜æœ‰å…‰è°±çš„æ„æ€)
lop			ç ï¼Œå‰ªæ ‘æã€‚  I feel as though a phantom limb is speaking to me, that something lopped off my soul is screaming to be reattached, only to remain a numb spectre of something warm and irrecoverable.   æˆ‘æ„Ÿè§‰ä»¿ä½›æœ‰ä»€ä¹ˆç¼ºå¤±çš„ä¸œè¥¿åœ¨å‘¢å–ƒï¼Œå°±åƒæ˜¯å¹»è‚¢æ„Ÿï¼Ÿä¸ºä»€ä¹ˆä»æˆ‘çµé­‚ä¸­å‰¥ç¦»çš„ä¸œè¥¿åœ¨å°–å«ç€è¦é‡æ–°å›æ¥ï¼Œå´ä¾ç„¶åªæ˜¯æ¸©æš–è€Œä¸å¯è§¦åŠçš„å¹»åƒï¼Ÿ
veritable 			çœŸæ­£çš„ï¼Œåå‰¯å…¶å®çš„ã€‚æ¥è‡ªvery(æ­£æ˜¯)
obsession			ç—´è¿·ï¼Œ[å¿ƒç†]å¼ºè¿«ç—‡  Twilight Sparkle had treated her career like a veritable obsession.     ä½†æš®å…‰é—ªé—ªå´çœŸæ­£ç—´è¿·åœ¨å¥¹çš„èŒä¸šä¹‹ä¸­äº†ã€‚
apt			é€‚å®œçš„ã€‚æ°å½“çš„ã€‚æ¥è‡ªè¯æ ¹ap-ï¼Œè¿æ¥ã€‚->åˆé€‚çš„ã€‚(co-up-leä¸€èµ·è¿æ¥->ä¸€å¯¹å„¿ï¼›ad-aptï¼Œå»-è¿æ¥é€‚åº”->é€‚åº”ï¼Œæ”¹ç¼–;ad-eptï¼ŒeptåŒaptï¼Œå»-è¿æ¥é€‚åº”->ç†Ÿç»ƒçš„æ“…é•¿çš„ï¼Œå†…è¡Œ)
commune		vå¯†åˆ‡è”ç³»ï¼Œèåˆä¸ºä¸€ä½“,nå¸‚é•‡ï¼Œç¤¾åŒºã€‚communityæ¥è‡ªcommuneã€‚  There are ponies here with whom she's had the opportunity to commune.   åœ¨è¿™é‡Œå¥¹å¯ä»¥å’Œå±…æ°‘ä»¬å°½æƒ…æ²Ÿé€šï¼Œäº¤æµã€‚

I've lived long enough to know that life is the sum of its days, and yet the flavor of its dreams.    æˆ‘å·²ç»æ´»äº†å¤Ÿä¹…ï¼ŒçŸ¥é“è¿™æ ·çš„æ—¥ç§¯æœˆç´¯ï¼Œä¾¿æ˜¯ç”Ÿæ´»--ç„¶è€Œï¼Œä¹Ÿæ˜¯æ¢¦æƒ³å’Œæ†§æ†¬æ‰€åœ¨ã€‚

scour			å†²åˆ·ï¼Œæ“¦æ´—ã€‚*å¼•ç”³ä¸ºæµè§ˆã€‚  I'll be scouring the texts for any tiny bit of info that can clue me into the magical secrets behind Nightmare Moon.   æˆ‘ä¼šåŸ‹è¿›æ–‡å­—å †é‡Œè‹¦è‹¦å¯»æ‰¾ä»»ä½•å¯èƒ½çš„è››ä¸é©¬è¿¹ï¼Œå¯ä»¥è®©æˆ‘äº†è§£æ¢¦é­‡ä¹‹æœˆèƒŒåçš„é­”æ³•ç§˜å¯†ã€‚
eke 			ç«­åŠ›ç»´æŒï¼Œå‹‰å¼ºç»´æŒã€‚å¸¸ç”¨eke outï¼š   They eke out a precarious existence foraging in rubbish dumps.    ä»–ä»¬é åœ¨åƒåœ¾åœºæ¡åƒåœ¾ç»´æŒç€æœä¸ä¿å¤•çš„ç”Ÿæ´».     attempting to eke beauty from the fringe of the wilderness around me å‹‰å¼ºä»åŒ…å›´ç€æˆ‘çš„è’é‡è¾¹ç¼˜å®ˆä½è‡ªå·±çš„ä¼˜é›….
entry			*æ¡ç›®ã€‚Every ten journal entries or so, I ask the same questionã€‚å¤§çº¦æ¯åç¯‡æ—¥è®°ï¼Œæˆ‘éƒ½ä¼šé—®ç›¸åŒçš„é—®é¢˜ã€‚
rhetoric	 ['rÉ›tÉ™rÉªk]		nä¿®è¾ã€‚adjèŠ±è¨€å·§è¯­çš„ã€‚æ¥è‡ªrhetorï¼Œå…¬ä¼—æ¼”è®²è€…(å¤å¸Œè…Šè¯­)ã€‚è¯æºåŒrhythm(rhet->rhytï¼Œè¡¨ç¤ºéŸµå¾‹ã€‚)       His rhetoric sounds like the death rattle of a fading leadership.  ä»–çš„æ…·æ…¨é™ˆè¯å¬èµ·æ¥åƒæ˜¯ä¸€ä¸ªè¡°è½çš„é¢†å¯¼å±‚å‚æ­»çš„æŒ£æ‰ã€‚
carousel 			æœºåœºä¼ é€å¸¦ï¼Œæ—‹è½¬æœ¨é©¬ã€‚æ¥è‡ªè¯æ ¹cur, è·‘åŠ¨ï¼Œè¯æºåŒcar ,chariot, current.
consecutive 		è¿ç»­ä¸æ–­çš„ã€‚con-å¼ºè°ƒã€‚secè¿æ¥ã€‚(è¯æºåŒsequence(åºåˆ—))ï¼Œutiveå½¢å®¹è¯è¯ç¼€ã€‚åŒconsistentï¼Œcontinuousã€‚     The same squirrel has crawled up to me for the fifth consecutive occasion.  åŒä¸€åªæ¾é¼ å·²ç»æ˜¯ç¬¬äº”æ¬¡çˆ¬åˆ°äº†æˆ‘èº«è¾¹ã€‚
morsel 			ä¸€å£ï¼Œå°å—(é£Ÿç‰©)ã€‚æ¥è‡ªæ‹‰ä¸è¯­mordere(å’¬)ï¼Œè¯æºmord-åŒmordant(è…èš€æ€§çš„)ï¼Œremorse(å‘åå’¬->æ‡Šæ‚”ï¼Œæ¯”å–»ç”¨æ³•ã€‚)
in a row			è¿ç»­åœ°ã€‚
*whimsy			æ€ªå¿µå¤´æ€ªæƒ³æ³•ã€‚å¯èƒ½æ˜¯æ‹Ÿå£°è¯(é£çš„å£°éŸ³)ï¼Œå°±åƒwhimper(å•œæ³£)ã€‚whinny(é©¬å˜¶å£°)
funnel	['fÊŒnl]		æ¼æ–—ã€‚æ¥è‡ª-fundï¼Œæ³¨å…¥ã€‚å¦‚fund(åŸºé‡‘)ï¼Œfoundry(é“¸é€ )
tuning fork		éŸ³å‰ã€‚
just short of screaming.	å°±å·®å«å‡ºæ¥äº†ï¼›åªæ˜¯æ²¡æœ‰å°–å«ã€‚
palpable			æ˜æ˜¾çš„ï¼Œå¯æ„ŸçŸ¥çš„ã€‚æ¥è‡ªpalpate,æ¥è§¦ã€‚è¯æºåŒpalpatant(é¢¤æŠ–çš„æ‚¸åŠ¨çš„)ï¼Œpalpae(è§¦é¡»â™‚)ã€‚
percussion		éœ‡åŠ¨ç¢°æ’,æ‰“å‡»ä¹å™¨ã€‚æ¥è‡ªcussion(å†²å‡»ç¢°æ’)ã€‚å¦‚concussion,å†²å‡»éœ‡è¡,â‰ˆprecussion
*capella			 [å¤©] äº”è½¦äºŒï¼ˆå¾¡å¤«åº§ä¹‹ä¸€ç­‰æ˜Ÿï¼‰ã€‚æ¸…å”±ã€‚
so long as I have joy to perceive,    åªè¦æˆ‘è¿˜èƒ½æ„Ÿè§‰åˆ°å¿«ä¹ï¼Œ
perch			n/væ†å­ï¼Œæ –æ¯ï¼Œé«˜ä½ã€‚   We watched the parade from our perch.  æˆ‘ä»¬ä»é«˜å¤„è§‚çœ‹æ¸¸è¡Œ.     The bird took its perch.   é¸Ÿåœæ­‡åœ¨æ –æœ¨ä¸Š.
scurry			ç–¾è·‘ã€‚hurry->scurryã€‚æ¥è‡ªhurryçš„éŸµå¾‹é‡å¤æ„è¯ã€‚   He winced at the sight of a scurrying spider and brushed loose a few flimsy cobwebs.   ä»–å…ˆæ˜¯è¢«ä¸€åªé£å¿«æºœèµ°çš„èœ˜è››å“äº†ä¸€å“†å—¦ï¼Œç„¶åæ¸æ‰äº†ä¹¦ä¸Šè¦†ç›–çš„ä¸€å±‚è–„è–„çš„èœ˜è››ç½‘ã€‚
brandish 			æŒ¥èˆã€‚æ¥è‡ªbrand(é“­åˆ»äºï¼Œå•†æ ‡ç‰Œå­ã€‚)
The jury's still out on...	 ...ä»æ²¡æœ‰å®šè®ºã€‚
detest			åŒæ¶æ†æ¨ã€‚de-å‘ä¸‹å¼ºè°ƒï¼Œ-testè§è¯ã€‚è¯æºåŒcontestäº‰è¾©(æ‰¾äººæ¥ä½œè¯çš„)ï¼›attestè¯æ˜ï¼›test(è¯æ˜->è€ƒå¯Ÿè€ƒè¯•)
eclipse			æ—¥èš€/æœˆèš€ã€‚ec-å‘å¤–ï¼Œ-lipseç•™ä¸‹ã€‚
*abduct			è¯±æ‹ï¼Œç»‘æ¶ã€‚æ¥è‡ªab-ç¦»å¼€ï¼Œduct-æ‹‰ï¼Œç‰µå¼•ã€‚
Aloe 			èŠ¦èŸï¼Œé¾™èˆŒå…°ã€‚
Lotus			è²èŠ±
frivolous 	 ['frÉªvÉ™lÉ™s]		æ— èŠçš„ï¼Œè½»ä½»çç¢çš„ã€‚å¯èƒ½æ¥è‡ªfri=frayç£¨æŸäº‰è®ºã€‚
pedicure			è¶³ç–—ï¼Œvä¿®è„šã€‚æ¥è‡ªpedi-è„šï¼Œcureæ²»ç–—ã€‚
massage 			næŒ‰æ‘©ã€‚æ¥è‡ªPIE*magæ‰æï¼ŒåŒæºè¯æœ‰make(åˆ¶ä½œ)ï¼Œmass(å—å„¿ï¼Œèšé›†)ã€‚  she needed far more than a frivolous massage or pedicure.   å¥¹æ‰€éœ€è¦çš„çš„è¿œä¸æ­¢æ˜¯ä¸€åœºæ— èŠçš„æŒ‰æ‘©æˆ–è€…è¶³æµ´ã€‚
*elation			å…´é«˜é‡‡çƒˆã€‚ä¸çŸ¥ä¸ºä½•ï¼Œä½ å¥½åƒå¤©ç”Ÿè®¤è¯†è¿™ä¸ªè¯ã€‚
identical 			å®Œå…¨ç›¸åŒçš„ã€‚
ritual			nä»ªå¼ã€‚adjä»ªå¼æ€§çš„ã€‚æ¥è‡ªriteï¼Œnä»ªå¼ä¹ ä¿—ã€‚    This was my fifth identical conversation with Twilight Sparkle, and I was only just then getting used to the whole ritual.   è¿™å·²ç»æ˜¯æˆ‘å’Œæš®å…‰é—ªé—ªç¬¬äº”æ¬¡è¿›è¡Œç›¸åŒçš„å¯¹è¯äº†ã€‚æˆ‘æ‰åˆšåˆšä¹ æƒ¯äº†è¿™ä¸€åˆ‡ã€‚
aroma			èŠ³é¦™ã€‚aroma=fragance=perfume=scent=bonquet=odour
ethereal 	 [Éª'Î¸ÉªrÉªÉ™l]		å¤©ä¸Šçš„ï¼Œç¥æ€§çš„ã€‚åƒç©ºæ°”ä¸€æ ·çš„ã€‚æ¥è‡ªetherä¹™é†š(è‹å¤©ã€‚è¿™æ˜¯å› ä¸ºä¹™é†šææ˜“æŒ¥å‘è€Œå–çš„åã€‚)   
theorize	['Î¸iÉ™raÉªz]		æ¨ç†ï¼Œå»ºç«‹ç†è®ºã€‚     I think... or at least I theorize.æˆ‘è¿™æ ·æƒ³....æˆ–è€…è‡³å°‘æ˜¯è¿™æ ·æ¨æµ‹çš„ã€‚
reticent 	['rÉ›tÉªsnt]		æ²‰é»˜çš„ï¼Œä¿ç•™çš„è°¨æ…çš„ã€‚re-è¡¨ç¤ºæŠ‘åˆ¶ã€‚è¯æºä¸ºæ‹‰ä¸è¯­tacereå®‰é™ã€‚å¦‚tacit=reticentã€‚
tacit	['tÃ¦sÉªt]		æ²‰é»˜çš„ï¼Œä¿ç•™çš„è°¨æ…çš„ã€‚	
vague 			æ¨¡ç³Šã€‚
stifle			çª’æ¯å‹åˆ¶æ‰¼æ€ã€‚å¯èƒ½æ¥è‡ªäºstiff(åƒµç¡¬åšå†³ä¸¥å‰)ã€‚æ¥è‡ªè¯æ ¹ste-/sto-/stu-/sti-å¡ç´§æ‰“åŒ…ã€‚å¦‚stifleçª’æ¯å‹åˆ¶ï¼›steepé™¡å³­çš„ï¼›stiffåƒµç¡¬çš„ï¼›stoopå¼¯è…°ï¼›stuffå¡è¿›å¡«å……(ç‰©å“ç©æ„å„¿)ï¼›
herring			é²±é±¼ã€‚æ¥è‡ªhoar(ç°ç™½è‰²ã€‚)       red herringsçº¢é²±é±¼ï¼ŒæŒ‡ä»£è½¬ç§»æ³¨æ„åŠ›çš„è¯é¢˜ã€‚	
It's taken me several months, and I am only barely scratching the surface of history's forgotten answersâ€”assuming that they are indeed answers, and just not red herrings disguised by the obscure layers of time. 
è¶³èŠ±äº†å‡ ä¸ªæœˆæ—¶é—´ï¼Œæˆ‘åªä¸è¿‡æ˜¯è§¦åŠäº†è¢«å†å²é—å¿˜çš„ç­”æ¡ˆä¸Šé¢é‚£å±‚åšåšçš„å°˜åŸƒè€Œå·²ã€‚è¿™è¿˜åªæ˜¯å‡è®¾å®ƒä»¬æ˜¯ç­”æ¡ˆï¼Œè¯´ä¸å®šæˆ‘è´¹å°½åƒè¾›ä¸‡è‹¦ä¹‹åï¼Œåªå‘ç°æˆ‘è¿½å¯»çš„åªæ˜¯å› ä¸ºæ—¶é—´ç£¨æŸè€Œæ¨¡ç³Šçš„æ··æ·†è€Œå·²ã€‚	

despot 	['dÉ›spÉ‘t]		ä¸“åˆ¶å›ä¸»ï¼Œæš´å›ç‹¬è£è€…ã€‚de-è¡¨å¼ºè°ƒï¼Œpot-åŠ›é‡ï¼Œå¦‚potentæœ‰åŠ›çš„æœ‰æƒåŠ¿çš„ã€‚
sentient	 ['sÉ›ntÉªÉ™nt]	æœ‰æ„Ÿè§‰çš„æœ‰æ„Ÿæƒ…çš„ã€‚æ¥è‡ªsenceã€‚

bane			æ¯’è¯ï¼Œç¥¸å®³ã€‚æ¥è‡ªgunæªã€‚
labyrinth 			è¿·å®«ã€‚labyæ¥è‡ªlobbyå¤§å…ã€‚  labyrinthineè¿·å®«èˆ¬çš„ã€‚-ineæ˜¯å½¢å®¹è¯åç¼€ã€‚
depict			æè¿°æç”»ã€‚æ¥è‡ªde-å‘ä¸‹ï¼Œ-pictç”»(picture)ã€‚å³ç”»ä¸‹ï¼Œæç»˜ã€‚
*cyclone			æ—‹é£ğŸŒ€ã€‚æ¥è‡ªcycleï¼Œåœˆã€‚-oneï¼Œå¤§è¯åç¼€ã€‚
uncanny			ç¥ç§˜çš„ç¦»å¥‡çš„å¯æ€•çš„ã€‚(ä¸èƒ½åšåˆ°->æ— æ³•è§¦åŠï¼Œç¥ç§˜ã€‚)æ¥è‡ªcannyï¼Œèƒ½å¹²çš„ã€‚æ¥è‡ªcanï¼Œèƒ½ã€‚
heinous   ['henÉ™s]		å¯æ†çš„å‡¶æ¶çš„ã€‚æ¥è‡ªhateã€‚åŒhatred
relish			væ¬£èµï¼Œå“å‘³ï¼›næ»‹å‘³é£å‘³ã€‚
trepidation		ææƒ§å¿§è™‘é¢¤æŠ–ã€‚æ¥è‡ªtrep-é¢¤æŠ–æ‘‡æ™ƒã€‚åŒæºè¯æœ‰trepid(ä¸å®‰çš„é¢¤æŠ–çš„)ï¼Œtripdant(é¢¤æŠ–çš„)ï¼Œtremble(éº»çƒ¦)ã€‚ä¹Ÿå¯èƒ½æ¥è‡ªè¯æ ¹ter-æ—‹è½¬/æ‘‡æ™ƒã€‚
sap			nç²¾åŠ›ï¼Œå…ƒæ°”æ´»åŠ›ï¼Œå‘é“ï¼›væŒ–æ˜ç ´åï¼ŒæŒ–åœ°é“ï¼Œä½¿ä¼¤å…ƒæ°”ã€‚
*fetlock			n. è·æ¯›ï¼ˆé©¬è¹„åæ–¹çš„ä¸›æ¯›ï¼‰ï¼›çƒèŠ‚ï¼ˆç”Ÿè·æ¯›å¤„ï¼‰

cap:è¶…äººæŠ«é£ã€‚
cloak:æ–—ç¯·ã€‚
mantle:æœ‰è¢–å­çš„æ–—ç¯·ã€‚

dew	  [du]		éœ²æ°´ã€‚å’Œdropæ˜¯åŒæºè¯(æµä¸‹)ã€‚morning dewæ™¨éœ²ã€‚
annihilate	   [É™'naÉªÉ™let]	vç­ç»æ­¼ç­ã€‚an-åŒad-å»ï¼Œè¯æ ¹nihil-é›¶ã€‚å¦‚nihilityï¼Œè™šæ— ã€‚nihilismï¼Œè™šæ— ä¸»ä¹‰ã€‚
paranoid			åæ‰§ç‹‚ï¼Œåæ‰§å¦„æƒ³çš„ã€‚æ¥è‡ªparanoiaåæ‰§å¦„æƒ³ç—‡ã€‚-iaæ˜¯ç–¾ç—…åç¼€ã€‚oid-ç±»ï¼Œåƒï¼Œè¯æºåŒandroid(å®‰å“ï¼Œå­—é¢ç¿»è¯‘"äººä¸€æ ·çš„").    I became nervous, paranoid, and easily frightened. æˆ‘å¼€å§‹å˜å¾—ç´§å¼ ï¼Œå¤šç–‘ï¼Œå®¹æ˜“å®³æ€•ã€‚
*bolero			è¥¿ç­ç‰™çš„ï¼‰æ³¢åˆ—ç½—èˆï¼Œæ³¢è±ç½—èˆæ›²ã€‚
mortify			ç¦æ¬²è‹¦ä¿®æ‹˜æŸç¾è¾±ã€‚æ¥è‡ªæ‹‰ä¸è¯­morsï¼Œæ­»ã€‚è¯æºåŒnortalç»ˆæœ‰ä¸€æ­»çš„ï¼Œmurderè°‹æ€ã€‚
*grandiose		=grandå®ä¼Ÿçš„ã€‚
impetus			åŠ¨åŠ›ï¼Œå†²åŠ›ã€‚è¯æºåŒimpact(å†²å‡»)ã€‚
retain			ä¿æŒï¼Œé›‡ä½£ï¼Œä¿ç•™è·å¾—ã€‚re-åŠ å¼ºã€‚tainä¿æŒï¼ŒåŒmaintainã€‚   He decided to retain him for the trial.   ä»–å†³å®šè˜è¯·ä»–ä¸ºå‡ºåº­å¾‹å¸ˆã€‚  I was retaining more knowledge than even poor Princess Luna herself.  æˆ‘é¢†æ‚Ÿçš„çŸ¥è¯†ç”šè‡³æ¯”å½“æ—¶å¯æ€œçš„éœ²å¨œä»ä¸­äº²èº«é¢†æ‚Ÿçš„éƒ½è¦å¤šã€‚
dissonance		ä¸å’Œè°çš„éŸ³ç¬¦ï¼Œä¸ä¸€è‡´ã€‚æ¥è‡ªson-å£°éŸ³ã€‚sonantï¼Œæœ‰å£°éŸ³çš„ï¼›sonalå£°éŸ³çš„å£°é€Ÿçš„...
lift			*(è¯…å’’/ç¦ä»¤)è§£é™¤ã€‚ My curse certainly wasn't being lifted with any of my subsequent performances.  æˆ‘çš„è¯…å’’å½“ç„¶ä¹Ÿä¸ä¼šéšç€æˆ‘çš„ä»»ä½•æ¼”å¥è€Œè§£é™¤ã€‚     making them do anything with the simple promise of lifting the very effects of the tune.      è¿™æ ·çš„æš´å›å¯ä»¥è®©ä»–ä»¬è¨€å¬è®¡ä»åœ°æœä»äºå¥¹ï¼Œåªè¦å¥¹ç®€å•åœ°æ‰¿è¯ºè§£é™¤è¿™é¦–æ›²å­çš„å½±å“å°±è¶³å¤Ÿäº†ã€‚
harrow			vè€™åœ°ï¼Œå¼€æ‹“ï¼Œ->ä½¿è‹¦æ¼ã€‚ The ox is never woe , till he to the harrow go.   ç‰›ä¸è€™åœ°ä¸çŸ¥è‹¦.
harrowing		ç—›è‹¦çš„æ‚²æƒ¨çš„ã€‚ You've had a harrowing time this past month.  è¿‡å»çš„è¿™ä¸ªæœˆä½ è¿‡å¾—å¤ªç—›è‹¦äº†ã€‚
guile 			nç‹¡çŒ¾ï¼Œæ¬ºè¯ˆã€‚"deceit, wile, fraud, ruse, trickery." ï¼ˆæœ‰æ—¶å¼•ç”³ä¸ºæˆ’å¤‡ã€è€èªæ˜ã€‚ï¼‰  It turned out that my guile was almost for nothing.The fifth elegy resulted in a very comforting experience.      ç»“æœäº‹å®è¯æ˜ï¼Œæˆ‘çš„æˆ’å¤‡å‡ ä¹æ˜¯ç™½è´¹äº†åŠ›æ°”ã€‚ç¬¬äº”é¦–æŒ½æ­Œçš„ç»“æœæ˜¯éå¸¸èˆ’ç•…çš„ã€‚
mimic			æ¨¡ä»¿ã€‚æ¥è‡ªmimeå“‘å‰§æ»‘ç¨½æˆæ¨¡æ‹Ÿè¡¨æ¼”ã€‚
*Anthem 			èµç¾è¯—æ­Œæ›²ã€‚
none other than 		ä¸æ˜¯åˆ«çš„ï¼Œè€Œæ­£æ˜¯...(åŠ å¼ºè¯­æ°”)     It was none other than the Anthem to the Lunar Empire.    è¿™æ›²å­ä¸æ˜¯åˆ«çš„ï¼Œæ­£æ˜¯â€œæ˜æœˆå¸å›½èµæ­Œâ€ã€‚
usurp	[ju'zÉp]		ç¯¡å¤ºç¯¡æƒã€‚æ¥è‡ªuseä½¿ç”¨ã€‚useå˜å½¢ä¸ºusuï¼Œrp-æŠ“ä½ï¼Œå¦‚rapture(ç‹‚å–œï¼Œæ¥è‡ªraptå…¨ç¥è´¯æ³¨çš„(ç²¾ç¥è¢«æŠ“ä½çš„,æ¯”å–»ç”¨æ³•))ã€‚       the dark alicorn attempted to usurp the power of her sister.    é»‘æš—å¤©è§’å…½ä¼å›¾ç¯¡å¤ºå¥¹å§å§çš„åŠ›é‡.
insidious			é˜´é™©çš„éšä¼çš„ã€‚in-è¿›å…¥ï¼Œä½¿ï¼›-sid-åä¸‹ï¼Œè¯æºåŒ(sitå;seatåº§ä½;)ã€‚åœ¨é‡Œé¢åç€->æ½œä¼ç€ã€‚  even the most insidious of tools we invent in this world all start as a noble work of art. å°±ç®—æ˜¯æˆ‘ä»¬åœ¨è¿™ä¸ªä¸–ç•Œä¸Šåˆ›é€ å‡ºçš„æœ€é˜´é™©å¥¸è¯ˆçš„å·¥å…·ï¼Œéƒ½æ˜¯ä»ä¸€æ ·é«˜è´µçš„è‰ºæœ¯æ°ä½œå‘æºçš„ã€‚
nefarious	 [nÉª'feÉ™rÉªÉ™s]	é‚ªæ¶çš„ç©·å‡¶ææ¶çš„ã€‚æ¥è‡ªne-æ— ï¼Œæ²¡æœ‰ï¼›fas-å…¬ç†.è¯æºåŒfate.->æ— å…¬ç†çš„ï¼Œä¸æ³•çš„ã€‚	inexplicable 		æ— æ³•è§£é‡Šçš„,è´¹è§£ç¥ç§˜çš„ã€‚æ¥è‡ªexplicit(adjæ¸…æ¥šæ˜ç™½çš„)ï¼Œexplicate(vè§£é‡Šæ¸…æ¥š)
blemish	  ['blÉ›mÉªÊƒ]		nç‘•ç–µæ±¡ç‚¹ï¼Œvç·æ±¡ã€‚è¯æºåŒbleachæ¼‚ç™½ã€‚   This is the one blemish on an otherwise resounding success.    å¦‚æœæ²¡æœ‰è¿™ä¸ªå°å°çš„å¤±è¯¯ï¼Œè¿™å°±æ˜¯ä¸€æ¬¡å½»åº•çš„èƒœåˆ©ã€‚	The blemish is gone. Where is the Mare in the Moon...?		ä¸Šé¢çš„é˜´å½±å“ªå„¿å»äº†ï¼Ÿå›šæœˆä¹‹é©¬å‘¢â€¦â€¦ï¼Ÿ
impressionable		æ•æ„Ÿçš„ï¼Œæ˜“å—å½±å“çš„ã€‚æ¥è‡ªimpresså½±å“ã€‚
warmonger		å¥½æˆ˜è€…ï¼Œæˆ˜äº‰è´©å­ä¸Šé¢çš„é˜´å½±å“ªå„¿å»äº†ï¼Ÿå›šæœˆä¹‹é©¬å‘¢â€¦â€¦ï¼Ÿï¼Œä¸»æˆ˜è®ºè€…ã€‚æ¥è‡ªmongerå•†äººè´©å­ã€‚è¯æºåŒmerchantã€‚
zealot			ç‹‚çƒ­è€…ï¼ŒçŠ¹å¤ªæ•™ç‹‚çƒ­ä¿¡å¾’ã€‚æ¥è‡ªzealçƒ­æƒ…ã€‚

the likes of sb/sth [informal]     (å°¤æŒ‡è¢«è§†ä¸ºå’ŒæŸäººæˆ–æŸäº‹ç‰©ä¸€æ ·å¥½çš„)ç§ç±»ï¼Œç±»å‹.     When I first played the â€œSunset Bolero,â€ I was pleased to not experience a wave of uneasiness the likes of which the Prelude afflicted me with.	å½“æˆ‘ç¬¬ä¸€æ¬¡æ¼”å¥â€œä½™æ™–æ³¢è±ç½—èˆæ›²â€ä¹‹é™…ï¼Œä¹‹å‰åœ¨åºæ›²ä¸­æŠ˜ç£¨æˆ‘çš„é‚£ç§æˆ˜æ —å’Œä¸å®‰å†ä¹Ÿæ²¡æœ‰å‡ºç°è¿‡ï¼ŒçœŸè®©æˆ‘å¼€å¿ƒä¸å·²ã€‚	She didn't want to associate with the likes of me.	å¥¹ä¸æƒ³ä¸æˆ‘è¿™ç§ç±»å‹çš„äººäº¤å¾€ã€‚
unravel			è§£å¼€,é˜æ˜,è§£å†³ã€‚æ¥è‡ªravelï¼Œnçº ç»“ï¼Œé”™ç»¼å¤æ‚çš„ä¸€å›¢ã€‚(ravelä¹Ÿå¯ä½œåŠ¨è¯=unravelã€‚è¯ä¹‰çš„çŸ›ç›¾æ€§å¯èƒ½æ˜¯æ¥è‡ªç¢æ¯›çº¿ ä¸€æ¾å¼€å°±ç¼ ç»•åœ¨ä¸€èµ·ã€‚)	 I've hoped to be many things at the end of unraveling this curse, but dead isn't one of them.    æˆ‘çš„ç¡®å¸Œæœ›åœ¨è§£å¼€è¿™ä¸ªè¯…å’’çš„æœ€åä¼šæœ‰å¾ˆå¤šæƒ…å†µå‘ç”Ÿï¼Œå¯ç»ä¸å¸Œæœ›å…¶ä¸­åŒ…æ‹¬æ­»äº¡ã€‚
treacherous    ['trÉ›tÊƒÉ™rÉ™s]	å¥¸è¯ˆçš„èƒŒå›çš„å±é™©çš„ã€‚æ¥è‡ªtreacheryèƒŒå›ä¸å¿ ï¼Œæ¥è‡ªtrickã€‚-eryè¡¨è¡Œä¸ºã€‚
foliage	       ['folÉª ÉªdÊ’]	æ¤ç‰©ï¼Œå¶å­(æ€»ç§°) "representation of leaves or branches"ã€‚å’Œfoil(è–„ç‰‡ï¼Œè¡¬æ‰˜ï¼Œé˜»æ­¢)ï¼ŒleafåŒæºã€‚    I was utilizing every bit of stamina in keeping myself from passing out in the middle of that dense foliage.	æˆ‘ç°åœ¨æ­£æŒ¤å‡ºæµ‘èº«ä¸Šä¸‹çš„æ¯ä¸€æ»´è€åŠ›æ¥é˜²æ­¢è‡ªå·±æ™•å€’åœ¨èŒ‚å¯†çš„æå¶é—´ã€‚
pass sth.  off		å†’å……æŸç‰©ã€‚ He tried to pass off his friend's idea as his own.ä»–è¯•å›¾æŠŠä»–æœ‹å‹çš„ç‚¹å­è¯´æˆæ˜¯ä»–è‡ªå·±çš„ã€‚
in and of itself		è·Ÿin itselfæ„æ€å·®ä¸å¤š:æœ¬èº«ï¼Œå°±å…¶æœ¬èº«è€Œè¨€ã€‚   It's a feat in and of itself to pass my condition off as a temporary illness.    å¦‚æœè¦æŠŠæˆ‘ç°åœ¨çš„çŠ¶å†µå½“åšå°æ¯›ç—…ï¼Œé‚£ç®€ç›´å°±æ˜¯åœ¨å®Œæˆä¸€é¡¹å£®ä¸¾ã€‚  	That stress in and of itself is actually good.   å‹åŠ›æœ¬èº«å…¶å®æ˜¯ä»¶å¥½äº‹ã€‚
speck			æ–‘ç‚¹æ±¡ç‚¹ã€‚=stain, spot, taint, blot, mark, smear, maculation, smudge, blotch, blemish, smirchã€‚		
steward	['stuÉšd]		ç®¡å®¶ï¼Œä¹˜åŠ¡å‘˜æœºç»„ã€‚-wardçœ‹ç®¡çœ‹æŠ¤ã€‚(wardç—…æˆ¿ï¼Œç›‘è§†)
syringe     [sÉª'rÉªndÊ’]		æ³¨å°„å†²æ´—ï¼Œå¸ç®¡/æ³¨å°„å™¨ã€‚inject/injectorã€‚injectorå¯ä»¥çœ‹æˆå‡çº§ç‰ˆçš„syringe(æŒ‡é‚£ç§å¯èƒ½æœ‰è‡ªåŠ¨/æ¶²å‹è£…ç½®çš„ç²¾ç¡®å¡«å……çš„user-friendlyçš„ç¬”å¤–è§‚çš„é‚£ç§ä¸€æ¬¡æ€§æ³¨å°„å™¨ï¼Œç±»ä¼¼è‚¾ä¸Šè…ºç´ ç¬”ã€‚)
*permafrost		æ°¸å†»åœŸã€‚è‡ªå·±æ‹†å§      I'd be warmer if I gathered a syringe full of permafrost and shoved it into an open vein.   	å¦‚æœæˆ‘æŠŠæ°¸å†»å†°å±‚çš„å†°æ°´æ³¨å°„åˆ°æˆ‘çš„è¡€ç®¡é‡Œï¼Œè¯´ä¸å®šæˆ‘è¿˜ä¼šæ„Ÿè§‰æ›´æš–å’Œå‘¢ã€‚
dissect			åˆ‡ï¼Œè§£å‰–ï¼Œè¯¦ç»†åˆ†æã€‚dis-åˆ†å¼€ï¼Œsectå‰ªã€‚åŒsectionï¼Œsegmentã€‚
tribulation		ç—›è‹¦ã€‚å¯èƒ½æ¥è‡ªtributeåŠå”è‡´æ•¬->ç—›è‹¦ï¼Ÿ(tribeéƒ¨è½ï¼Œæ¥è‡ªtri-ä¸‰ï¼Œbe-å­˜åœ¨)      It was a noble goal, and it was worth all of the trials, tribulations, and shivers... most of the time.	è¿™æ˜¯ä¸€ä¸ªå´‡é«˜çš„ç›®æ ‡ï¼Œæ‰€æœ‰è¿™äº›è€ƒéªŒã€ç£¨éš¾ã€é¢¤æŠ–â€¦â€¦å…¨éƒ½å€¼äº†ã€‚â€¦â€¦è‡³å°‘æ˜¯å¤§å¤šæ•°æ—¶å€™å§ã€‚
threshold	      ['Î¸rÉ›Êƒhold]	é˜ˆå€¼ï¼Œé—¨æ§›ï¼Œå¼€ç«¯ï¼Œæé™ï¼Œä¸´ç•Œå€¼ã€‚æ¥è‡ªthresh(æ¨æ•²ï¼Œæ‰“ã€‚)	We are on the threshold of a new era in astronomy.	æˆ‘ä»¬å¾ˆå¿«å°±å°†è¿æ¥å¤©æ–‡å­¦çš„æ–°çºªå…ƒã€‚	I clung to myself, shivering upon the threshhold.	æˆ‘æ”¯æ’‘ç€èº«ä½“ï¼Œåœ¨é—¨å‰é¢¤æŠ–ã€‚
concoct			æ··åˆåˆ¶ä½œï¼Œæé€ ï¼Œå›¾è°‹ã€‚concoctionæ··åˆç‰©ã€‚  con-å¼ºè°ƒ-coctæ˜¯cookçš„å˜ä½“ï¼Œå³æ”¾åœ¨ä¸€èµ·ç…®çš„-.æ··åˆç†¬åˆ¶ã€‚ 	She stood over a bubbling cauldron, squinting at a series of herbs that she was sprinkling over a new and experimental concoction. 	å¥¹æ­£ç«™åœ¨ä¸€å£å†’æ³¡çš„è¯é”…å‰ï¼Œçœ¯ç€çœ¼ç›æ£€æŸ¥ç€ä¸€ç³»åˆ—ç”¨æ¥åˆ¶é€ æ–°å®éªŒè¯å“çš„è‰è¯ã€‚
icicle			å†°æŸ±å†°å¨å­ã€‚
reagent			è¯•å‰‚ï¼Œååº”ç‰©ã€‚è¿™æ¥è‡ªreactååº”å’Œagent(è¯å‰‚)ã€‚
*ram			å±±ç¾Šï¼Œç™½ç¾Šæ˜Ÿåº§ã€‚
*broth			è‚‰æ±¤ï¼Œæ¶²ä½“åŸ¹å…»åŸºã€‚å’Œbrew(é…¿é€ ,è¯å‰‚)åŒæºã€‚	
*attire			æœè£…ï¼Œæ‰“æ‰®ã€‚at-åŒadå»ï¼ŒtireåŒtier(å±‚)
*dire			å¯æ€•çš„æ‚²æƒ¨çš„ã€‚è¯æºåŒdinosauræé¾™ã€‚
*inclement 		é™©æ¶çš„ï¼Œç‹‚é£æš´é›¨çš„ã€‚æ¥è‡ªclementæ¸©å’Œä»æ…ˆçš„ï¼Œå½¢å®¹å¤©æ°”(å’ŒclimateåŒæº)the climate is clement.æ°”å€™å®œäººã€‚
*prehensile 		å–„äºé¢†ä¼šçš„ï¼Œé€‚äºæŠ“æ¡çš„ã€‚æ¥è‡ªprehens-æŠ“ä½ã€ç†è§£ã€‚(prehensionç†è§£ï¼ŒæŠ“ä½â‰ˆcomprehensionç†è§£ï¼ŒåŒ…å«)
tarry			ç­‰å¾…é€—ç•™ã€‚
infirm			è¡°å¼±çš„ä¸åšå›ºçš„ã€‚æ¥è‡ªfirmåšå›ºã€‚
*leprosy			éº»é£ç—…ï¼Œè…è´¥ã€‚æ¥è‡ªleperéº»é£ç—…æ‚£è€…ï¼Œä¸æ„¿æ¥è§¦çš„äººå—è”‘è§†çš„äººã€‚
*arthritis			å…³èŠ‚ç‚ã€‚arthr-å…³èŠ‚ï¼Œæ¥è‡ªè¯æ ¹ar(è¿æ¥)ï¼Œ-itisç‚ç—‡,Inflammation.ä¾‹å¦‚Conjunctivitisç»“è†œç‚ï¼ŒNephritisè‚¾ç‚(neph=nephelometryè‚¾)ï¼Œ...
*metronome 		èŠ‚æ‹å™¨ã€‚å’ŒmeteråŒæºï¼Œæ¥è‡ªå¸Œè…Šè¯­metronæµ‹é‡ã€‚
encroach 			ä¾µçŠ¯ä¾µèš€ã€‚en-è¿›å…¥ã€‚æ¥è‡ªcrooké’©å­ã€‚åŒæºè¯æœ‰crochetç”¨é’©é’ˆç¼–ç»‡ã€‚
engraving 		ç‰ˆç”»ã€‚
socket			æ’åº§ï¼Œç©´ï¼Œçªã€‚I felt like my eyeballs would freeze in their sockets.	æˆ‘è§‰å¾—æˆ‘çš„çœ¼ç è¦å†»ç»“åœ¨çœ¼çªé‡Œäº†ã€‚
whimsical			*å¹½é»˜çš„ã€‚(å¼‚æƒ³å¤©å¼€çš„)	I'm sure that the chuckle coming out of her lips was meant to be whimsical. 	æˆ‘æ•¢è‚¯å®šï¼Œé‚£ç¬‘å£°æ˜¯å‘è‡ªå¹½é»˜æ„Ÿã€‚
*nauseate   ['nÉ”zÉªet]		vä½œå‘•ï¼ŒåŒæ¶ã€‚ (å’Œnaughtæ·˜æ°”åŒæºã€‚)
*slosh			næ³¥æµ†æ±¡æ°´ï¼Œvæ™ƒåŠ¨æ…æ‹Œï¼Œæº…ï¼Œæ³¼ã€‚=slush.	more nauseating than all of the world's exotic brews sloshed together.	æ¯”ä¸–ç•Œä¸Šæ‰€æœ‰çš„å¼‚æ—é¥®æ–™éƒ½è¦æ¶å¿ƒã€‚
*tundra 	  ['tÊŒndrÉ™]		å†»åœŸåœ°å¸¦ï¼Œå†»åŸï¼Œè‹”åŸã€‚
oblivious 			å¥å¿˜çš„ï¼Œé—å¿˜çš„ã€‚
formidable 		å¼ºå¤§å¯æ€•çš„è‰°éš¾ä»¤äººæ•¬ç•çš„ã€‚è¯æ ¹formid-æ¥è‡ªæ‹‰ä¸è¯­formidoææƒ§ã€‚(for-å®Œå…¨,è¡¨å¼ºè°ƒ)
acoustic 			å£°å­¦çš„å¬è§‰çš„ã€‚(=acoustical)æ¥è‡ªè¯æ ¹acoust.
shack 			æ£šå±‹ã€‚=shed
latch			é—¨é—©ï¼Œæ’é”€ã€‚
flight 			*ä¸€æ®µæ¥¼æ¢¯ã€‚	Reaching the shack, I unlatched the wooden door and opened it, revealing a hidden flight of wooden steps that led down a steep trench dug out of the earth.	åˆ°è¾¾çªæ£šçš„æ—¶å€™ï¼Œæˆ‘å¼€äº†æœ¨é—¨çš„é”ï¼Œå¼€é—¨ä¹‹åï¼Œé‡Œé¢éœ²å‡ºäº†ä¸€æ®µéšè—çš„æœ¨å¤´å°é˜¶ï¼Œä¸€ç›´é€šå‘åœ°ä¸‹æŒ–å‡ºæ¥çš„é™¡å³­æ²Ÿæ¸ ã€‚
niche	[niÊƒ]		n.å£é¾›ï¼Œ(å±±ä½“/æ‚¬å´–ä¸Šçš„)å‡¹æ´ã€‚	I hung the lantern from a metal hook implanted in the roof of the underground niche. 	æˆ‘æŠŠæ²¹ç¯æŒ‚åœ¨åœ°ä¸‹å®¤å¤©èŠ±æ¿å‚ä¸‹æ¥çš„é“é’©å­ä¸Š
barricade			è·¯éšœï¼Œè®¾è·¯éšœé˜»ç¢ã€‚cade-æ˜¯åŠ¨è¯åç¼€ã€‚è¯æºåŒbarrel, æ¡¶ã€‚è¯¥è¯æ¥è‡ªäºå·´é»1588å¹´çš„ä¸€æ¬¡Huguenotæš´åŠ¨ï¼Œå¤§é‡çš„æ¡¶è£…æ»¡æ³¥åœŸï¼Œæ²™çŸ³ç­‰å †æ”¾åœ¨é©¬è·¯ä¸­é—´ï¼Œå µå¡ä¸»å¹²é“ã€‚è€Œå…·ä½“åˆ›é€ å‡ºè¯¥æ–¹æ³•ä¹‹äººå·²ä¸å¯è€ƒã€‚
gravel 			ç¢çŸ³ç ‚ç ¾ã€‚(æ˜¾ç„¶å’ŒgraveåŸå¢“åŒæºã€‚)-elå°è¯åç¼€è¡¨ç¤ºç»†ç¢çš„å°å—ã€‚è¯æºæ¥è‡ªgrit(ç ”ç£¨)ã€‚	The floor was a sea of even gravel that crunched under my hooves.	æ•´ä¸ªåœ°æ¿æ˜¯ç¢çŸ³çš„å¤§æµ·ï¼Œåœ¨æˆ‘è¹„ä¸‹å’¯å±ä½œå“ã€‚
*leyline			åœ°è„‰ã€‚leylines of magicï¼Œé­”æ³•çº¿ã€‚
altruism			åˆ©ä»–ä¸»ä¹‰ã€‚æ¥è‡ªalter-å¼‚->ä»–äººã€‚
throe			å‰§ç—›ã€‚
gulf=gulp			åå’½ã€‚æ˜¯æ‹Ÿå£°è¯ã€‚(å…¶ä¸­gulfå¼•ç”³ä¸ºæµ·æ¹¾ã€æ·±æ¸Šã€‚)
eerie 	['ÉªÉ™rÉª]		å¯æ€•æ€ªå¼‚çš„ã€‚
*pulsate			=pulseæåŠ¨æ‚¸åŠ¨ï¼Œbeatï¼Œthrobã€‚
broadly			æ˜æ˜¾åœ°ï¼Œæ¦‚æ‹¬æ€§åœ°ã€‚(æ¥è‡ªbroadå®½å¹¿çš„)
bear down		å…‹æœï¼Œå‹åˆ¶ã€‚	I felt as though the weight of twenty thousand generations of moon phases was bearing down on my body. 	ä»¿ä½›ä¸¤ä¸‡ä»£æœˆç›¸çš„é‡é‡æ­£å‹åœ¨æˆ‘çš„èº«ä¸Šã€‚
mesmerize		è¿·ä½ï¼Œæ–½å‚¬çœ æœ¯ã€‚æ¥è‡ª19ä¸–çºªå¥¥åœ°åˆ©åŒ»ç”ŸMesmer,å› ä»–å‘æ˜äº†ä¸€ç§å‚¬çœ æœ¯è€Œå¾—åã€‚	mesmerizing cadence	ä¼˜ç¾çš„èŠ‚å¥ã€‚(mesmerizingä»¤äººç€è¿·çš„ä¼˜ç¾çš„)
*alabaster 		é›ªèŠ±çŸ³è†ï¼Œå…‰æ´é›ªç™½çš„ã€‚(åŸƒåŠè¯­ã€‚é˜¿æ‹‰å·´æ–¯å¦å›½åé›†å–è¿™ç¾å¥½å«ä¹‰)
tenacity			éŸ§æ€§ï¼Œé»æ€§ï¼Œå›ºæ‰§ã€‚	I skated across the alabaster surface of its melody with tenacity.	æˆ‘åšå®šä¸ç§»åœ°æ»‘è¿‡é›ªèŠ±çŸ³è†èˆ¬çš„æ—‹å¾‹è¡¨é¢ã€‚
nimble 			çµæ´»çš„æ•æ·çš„ï¼Œagileã€‚
arsenal	['É‘rsÉ™nl]		å…µå·¥å‚å†›æ¢°åº“ã€‚
thereof			=of thereï¼Œå®ƒçš„ï¼Œç”±æ­¤ã€‚	All citizens of the United States are ruled by the laws thereof.	ç¾å›½çš„æ‰€æœ‰å…¬æ°‘å‡é¡»å—å›½å®¶æ³•å¾‹ä¹‹çº¦æŸ.	It was the death of all my music and the anthem thereof. 	è¿™æ˜¯æˆ‘æ‰€æœ‰éŸ³ä¹çš„æ­»äº¡ç»ˆç‚¹ï¼Œä¹Ÿæ˜¯æˆ‘æ‰€æœ‰éŸ³ä¹çš„èµç¾è¯—ã€‚
anthem			èµç¾æ­Œã€‚(åœ¨è‹±è¯­é‡Œç‰¹æŒ‡å›½æ­Œã€‚)
devoid 			ç¼ºä¹çš„ã€‚de-å¼ºè°ƒï¼Œå®Œå…¨çš„ã€‚voidç©ºçš„ã€‚å³ç¼ºä¹çš„ã€‚
dirge 			æŒ½æ­Œã€‚æ¥è‡ªdirectå¼•å¯¼ã€‚æŒ½æ­Œæ˜¯å¼•å¯¼äº¡çµçš„ã€‚	I tackled the dirge like a monk,pure in form and devoid of flare.	é¢å¯¹è¿™é¦–æŒ½æ­Œï¼Œæˆ‘å®›å¦‚ä¸€ä½è™”è¯šçš„åƒ§ä¾£ï¼Œå¿ƒå¦‚æ­¢æ°´ï¼Œæ— å–œæ— å¿§ã€‚
reaper			æ”¶å‰²è€…->æ­»ç¥ã€‚
farce			é—¹å‰§ç¬‘å‰§ã€‚è¯æºåŒfartæ”¾å±(æ»‘ç¨½æ„å‘³)
solemnity (åº„ä¸¥)<-->solitude(å­¤ç‹¬)	soleåŒæºè¯ï¼Œæ³¨æ„åŒºåˆ«ã€‚
excruciate			æŠ˜ç£¨ã€‚ex-å‘å¤–ï¼Œcrucialé‡è¦çš„å…³é”®çš„ã€‚(è¯æ ¹ä¸ºcrossåå­—ã€‚å¦‚cruciateåå­—å‹çš„ã€‚)è¿™å¯èƒ½æ˜¯åå­—æ¶å’Œåˆ‘ç½šç»‘å®šçš„å¼•ç”³ã€‚	The solemnity of the tune was excruciating to my ears.	è¿™é¦–æ›²å­çš„æ£®ä¸¥è‚ƒç©†åœ¨æˆ‘è€³ä¸­æåº¦ç—›è‹¦ã€‚
punctuation		æ ‡ç‚¹ç¬¦å·ã€‚æ¥è‡ªpunctuateå¼ºè°ƒï¼ŒåŠ æ ‡ç‚¹ï¼›è¯æ ¹ä¸ºpunctåˆºã€‚(å¼•ç”³ä¸ºç²¾ç¡®ã€å‡†æ—¶punctualï¼›æ ‡ç‚¹(åˆº->åˆ†å¼€å¥å­))
ravine			æ²Ÿå£‘å±±è°·ã€‚è¯æºrapere(æŠ“)ï¼ŒåŒrapeå¼ºå¥¸ï¼›ravenæ å¤ºï¼›rapidå¿«é€Ÿçš„ã€‚raveå’†å“®ã€‚	I could have sworn the cellar had morphed into a bottomless ravine. 	æˆ‘éƒ½å‘èª“è¿™åœ°çª–å·²ç»å˜æˆæ— åº•æ·±æ¸Šäº†ã€‚
gobble			åé£Ÿï¼Œç‹¼åè™å’½ã€‚æ¥è‡ªgobå˜´ã€‚
cord			*å’Œchordæœ‰æ—¶æ··ç”¨(cordç»³å­->å¼¦)ã€‚Was it the sound stones creating this deathly silence that gobbled up the vibrating edge of each cord? 	æ˜¯éŸ³çŸ³åˆ›é€ äº†è¿™ç§æ­»å¯‚ï¼Œåå™¬äº†æ¯æ ¹ç´å¼¦æŒ¯åŠ¨çš„éŸ³æ³¢å—ï¼Ÿ	
navel 	 ['nevl]		ä¸­å¿ƒç‚¹ï¼Œè‚šè„ã€‚
intestine	 [Éªn'tÉ›stÉªn]		è‚ å­ã€‚å†…éƒ¨çš„ã€‚int-=inåœ¨å†…éƒ¨ã€‚-estå­˜åœ¨ã€‚æ¶ˆåŒ–(digest)	
wheeze	 [wiz]		å–˜æ¯ã€‚æ‹Ÿå£°è¯ã€‚
maw 			åŠ¨ç‰©çš„èƒƒã€‚
entreat			è¯·æ±‚ï¼Œç¥ˆæ±‚ã€‚"to enter into negotiations, especially discuss or arrange peace terms;" 	en-ä½¿ï¼Œtreatå¤„ç†ã€‚ä½¿å¯¹æ–¹å¤„ç†->æ³æ±‚ã€‚	 I entreated the walls and the walls buckled. 	æˆ‘å‘ç€å¢™å£ç¥ˆæ±‚ï¼Œè€Œå®ƒä»¬å´è½°ç„¶å€’å¡Œã€‚
deluge			æ´ªæ°´ã€‚de-å‘ä¸‹ï¼Œlug-å†²æ´—å–·æµã€‚è¯æºåŒlavaï¼Œfloodã€‚
sheen 			å…‰æ³½ï¼Œå…‰è¾‰ã€‚è¯æºåŒshineã€‚
penumbra 		åŠå½±ã€‚pen-=pene-å‡ ä¹ã€‚	umbraè¯æºåŒumbrellaé˜´å½±ã€‚	Alone in the penumbra of all my hopes and horrors I cuddled that voice and I heard...	åœ¨æˆ‘æ‰€æœ‰çš„å¸Œæœ›ä¹‹ä¸­ï¼Œåœ¨æˆ‘æ‰€æœ‰çš„ææƒ§ä¹‹ä¸­ï¼Œåœ¨å¸Œæœ›å’Œææƒ§çš„é˜´å½±è¾¹ç¼˜ï¼Œæˆ‘å­¤ç‹¬åœ°ç´§æŠ±ç€é‚£ä¸ªå£°éŸ³ï¼Œæˆ‘å¬åˆ°äº†â€¦â€¦
*gazelle 			çªç¾š
sprawl			è”“å»¶ï¼Œä¹±æ‘Šå¼€ã€‚spread+crawlã€‚	I look up from a sprawling assortment of textbooks and notes across my bed covers.	æˆ‘ä»æ»¡åºŠä¹±æ‰”çš„è¯¾æœ¬å’Œç¬”è®°ä¸ŠæŠ¬èµ·å¤´æ¥ã€‚
scoop			å‹ºå­ï¼Œæ˜ã€‚	â€œOh shoot!â€ I scramble to scoop up all of my study materials and shove them into a turquoise saddlebag. 	â€œå—·ï¼Œè§é¬¼ï¼â€æˆ‘å°–å«ä¸€å£°ï¼Œæ…Œé‡Œæ…Œå¼ åœ°æŠŠæ‰€æœ‰çš„å­¦ä¹ ææ–™éƒ½æ¡èµ·æ¥ï¼Œå¡è¿›äº†ç»¿æ¾çŸ³è‰²çš„éåŒ…é‡Œã€‚
*turquoise    ['tÉkwÉ”Éªz]	ç»¿æ¾çŸ³ï¼Œè“ç»¿è‰²ã€‚(ç›´è¯‘ä¸ºæ¥è‡ªåœŸè€³å…¶çš„çŸ³å¤´ï¼Œå’ŒturkishåŒæº)
tonality 			éŸ³è°ƒã€‚æ¥è‡ªtoneã€‚
slack 			æ¾å¼›æ¾æ‡ˆï¼›æ¾å¼›çš„æ¾æ‡ˆçš„ã€‚æ¥è‡ªPIE*sleuæ— ç²¾æ‰“é‡‡çš„ï¼Œè¯æºåŒrelaxï¼Œslowã€‚		I can't let myself slack off for even a second!	æˆ‘ä¸€ç§’é’Ÿéƒ½ä¸èƒ½æ”¾æ¾ï¼
groan			å‘»åŸæŠ±æ€¨ã€‚æ‹Ÿå£°è¯ã€‚	 I linger in the middle of the stairs, groaning. â€œDon't tell me... What have I forgotten now?â€	æˆ‘åœ¨æ¥¼æ¢¯ä¸­é—´è½¬æ‚ ç€ï¼Œæ— åŠ›åœ°å¹ç€æ°”ã€‚â€œåˆ«å‘Šè¯‰æˆ‘â€¦â€¦æˆ‘åˆå¿˜äº†å•¥ï¼Ÿâ€
peck 			å•„é£Ÿï¼Œè½»è½»äº²å»ã€‚æ¥è‡ªpickå˜ä½“ï¼Œæ¡æ‹¾->å•„ã€‚	 I dash over to give him a swift peck on the cheek. 	æˆ‘å†²è¿‡å»åœ¨ä»–è„¸ä¸Šé£å¿«åœ°äº²äº†ä¸€ä¸‹ã€‚
*cantaloupe		å“ˆå¯†ç“œğŸˆï¼Œç”œç“œã€‚ 
jostle	 ['dÊ’É‘sl]		æ¨æŒ¤ï¼Œæ’ï¼Œäº‰å¤ºã€‚æ¥è‡ªjoustç«äº‰å®æ‰“ï¼Œ-leè¡¨ç¤ºåå¤ã€‚		The train car keeps jostling.	ç«è½¦è½¦å¢ä¸€ç›´é‚£ä¹ˆæ‹¥æŒ¤ã€‚
scribble 			æ½¦è‰å†™æˆçš„æ‚æ–‡ï¼Œä¹±å†™ã€‚æ¥è‡ªscribe(å†™ä¸‹)ã€‚-leè¡¨åå¤ã€‚åŒæºæœ‰describeæè¿°(å³de-è¡¨å¼ºè°ƒ+scribeå†™)ï¼›script(è„šæœ¬)	I scribble a few things in my notepad.	äºæ˜¯æˆ‘åœ¨ç¬”è®°æœ¬ä¸Šæ½¦è‰åœ°è®°äº†äº›ä¸œè¥¿ã€‚
*Adagio 			æŸ”æ¿æ…¢æ¿ã€‚
mill			ç£¨åŠï¼Œæ…æ‹Œç£¨ç»†ã€‚
thatch			èŒ…è‰ï¼Œæ‚è‰ã€‚	I see apple trees, a windmill, thatched roofs, a bell tower, and more apple trees.	æˆ‘çœ‹åˆ°è‹¹æœæ ‘ï¼Œé£è½¦ï¼ŒèŒ…è‰å±‹é¡¶ï¼Œé’Ÿå¡”ï¼Œè¿˜æœ‰æ›´å¤šçš„è‹¹æœæ ‘ã€‚
muzzle 			æªå£ï¼›åŠ¨ç‰©çš„é¼»å£ã€‚å’Œmorsel(ä¸€å£é£Ÿç‰©)åŒæº
glisten			é—ªå…‰é—ªè€€ã€‚å’Œgloss/glintåŒæºã€‚
bulge 			è†¨èƒ€ï¼Œä½¿å‡¸èµ·ã€‚è¯æºåŒballï¼Œè†¨èƒ€ã€‚	There is something weighing on her, and I think it's more than just the farm family's sweets forming a bulge in her belly. 	å¥¹å¥½åƒæœ‰ä»€ä¹ˆè´Ÿæ‹…ï¼Œä¼°è®¡åº”è¯¥ä¸æ­¢æ˜¯è¿™ä¸ªçƒ­æƒ…å†œå®¶ç¡¬å¡è¿›å¥¹è‚šå­é‡Œçš„é‚£ä¸€å¤§å †ç”œç‚¹ä»€ä¹ˆçš„ã€‚
protege  ['prÉ™uteÊ’ei]	é—¨å¾’ï¼Œè¢«ä¿æŠ¤è€…ï¼Œé—¨ç”Ÿï¼Œå—ææºçš„åè¿›ã€‚æ¥è‡ªprotectä¿æŠ¤ã€‚
charge			*å†²é”‹ã€‚lead the charge  å¸¦å¤´å†²é”‹ã€‚
chomp			æ ¼æ ¼å’¬ç‰™ï¼Œåˆ‡é½¿ï¼Œå¤§å£°åœ°åƒã€‚åŒchampã€‚æ‹Ÿå£°è¯ã€‚(ä¸è¿‡æ³¨æ„champæœ‰æ—¶æ˜¯championçš„ç®€å†™)
*sarsaparilla		æ²™å¸æ±½æ°´ã€‚
*shindig			ç››å¤§èšä¼šã€‚å¯èƒ½æ¥è‡ªshin(èƒ«éª¨->è…¿)+dig(æŒ–->æ‘‡æ‘†)-->è·³èˆğŸ’ƒã€‚
*termite			ç™½èšã€‚
*bellhop			ä¿¡å·®ï¼Œåšæ‚æ´»çš„æœåŠ¡ç”Ÿã€‚(å¤§è…¿ä¸Šç»‘ä¸ªé“ƒé“›??)
devilish			é‚ªæ¶çš„->ç²¾åŠ›æ—ºç››çš„ã€éå¸¸çš„ã€‚æ¥è‡ªdevil-ishã€‚
stake			æ¡©ï¼Œè‚¡ä»½ï¼Œé‡å¤§åˆ©ç›Šï¼Œä¸‹èµŒæ³¨ã€‚There's so much at stake!	è¿™ä»¶äº‹å…³ç³»é‡å¤§!
fruition			ç»“æœå®->å®Œæˆã€‚	Things that have been set in motion long before history can remember will come into fruition.	æœ‰äº›æœªæ›¾æ¥å¾—åŠè®°å½•åœ¨å†å²ä¸­çš„å¾€äº‹å°±è¦è¯ç”Ÿå‡ºåæœäº†ï¼(set in motion--å¯åŠ¨ã€‚)
get washed up over nothing  ä½ æœ‰ç‚¹ä¸å¿…è¦åœ°ç„¦è™‘è¿‡å¤´äº†ï¼	You're getting all washed up over nothing, Twilight.	ä½ å°±åˆ«å¤ªæ¿€åŠ¨å•¦ï¼Œæš®å…‰ã€‚
brisk			è½»å¿«çš„å‡‰çˆ½çš„æ•é”çš„ã€‚è¯æºåŒbreakå†²ç ´->æ•é”ã€‚
confetti 			äº”å½©çº¸å±‘ã€‚æ¥è‡ªconfectionç³–æœğŸ¬ã€‚
comfitç³–æœ,èœœé¥¯ã€‚
confectç³–æœ,èœœé¥¯ã€‚
confectionç”œé£Ÿ,ç³•ç‚¹ã€‚
å…¶å®è¿™ä¸‰ä¸ªå•è¯çš„è¯æ ¹æ„æˆéƒ½ä¸€æ ·:ä¸€èµ·+åš,æ€å¥ˆä½•æœ‰è¿™éº½å¤šåšçš„èŠ±æ ·?å¯è§è‹±è¯­ä¸æ˜¯ä¸€èˆ¬çš„å˜æ€,è€Œæ˜¯ç‰¹åˆ«å˜æ€ã€‚
get a lay of...	ç†Ÿæ‚‰ä¸€ä¸‹ã€‚è¿™é‡Œçš„layæŒ‡overallçš„ä¸€ä¸ªlayoutã€‚		I should have gotten a lay of the land.	æˆ‘æœ¬æ¥åº”è¯¥å…ˆå››å¤„èµ°èµ°ç†Ÿæ‚‰ä¸€ä¸‹åœ°æ–¹ã€‚
*helm 			èˆµï¼Œé©¾é©¶ç›˜ã€‚æœ‰æ—¶ä¹Ÿæ˜¯helmetå¤´ç›”çš„ç®€å†™ã€‚
*onyx			ç›ç‘™ã€‚
crescent 			æ–°æœˆã€‚ä¼Šæ–¯å…°æ•™æ ‡è®°ï¼ŒåœŸè€³å…¶å›½å¾½ã€‚cresc-åŒcreatï¼ŒæŒ‡(ğŸŒ™)åˆ›é€ ç”Ÿé•¿ã€‚
scrap			ç¢ç‰‡ã€‚æ¥è‡ªscrape(åˆ®ï¼Œæ“¦ï¼Œç£¨)çš„å¯¹è¯å½¢å¼ã€‚æ¥è‡ªPIE*skerç åˆ‡å‰Šï¼Œå¦‚share,shear,scrub.	
rupture			ç ´è£‚ã€‚è¯æºåŒrapeï¼Œrip(æ’•æ‰¯)ï¼Œrob
tatter			=rupture=ripï¼Œæ’•æ‰¯æ‰¯çƒ‚ï¼›nç¢ç‰‡ã€‚	I'm just a discarded scrap of refuse, cluttering the ruptured ground beside my fallen lyre and tattered saddlebag.	æˆ‘åªæ˜¯ä¸€å †è¢«æŠ›å¼ƒçš„åƒåœ¾ï¼Œæ•£è½åœ¨æˆ‘å€’ä¸‹çš„ä¸ƒå¼¦ç´å’Œç ´çƒ‚çš„é©¬éåŒ…å‘¨å›´ç¢è£‚çš„åœŸåœ°ä¸Šã€‚
*flail			è¿æ·ï¼Œé­æŒï¼ŒæŒ£æ‰ï¼ŒçŒ›å‡»ã€‚	I flail.	æˆ‘æŒ£æ‰ç€ï¼Œæ‰‘è…¾ç€ã€‚
delirious			ç²¾ç¥é”™ä¹±çš„ã€‚æ¥è‡ªè¯æ ¹delir-ï¼Œç²¾ç¥é”™ä¹±ã€‚å¦‚deliriumã€‚	Dear Celestia, she's delirious.	å™¢å¡æ‹‰æ–¯è’‚å¨…å•Šï¼Œå¥¹ç¥å¿—ä¸æ¸…äº†ã€‚
seizure			nå¤ºå–å é¢†æ²¡æ”¶-->ç–¾ç—…çªå‘ï¼›æ¥è‡ªseizeå¤ºå–æŠ“ä½ã€‚	Quick. I think she's going into a seizure or something!	èµ¶å¿«ï¼Œå¥¹å¯èƒ½æ˜¯å¤±å¿ƒç–¯å‘ä½œäº†!
prod			åˆºï¼Œé’ˆï¼Œæˆ³ã€‚æ¥è‡ªpr-åˆº(prick)+rod(æ£’ï¼Œæƒ©ç½šï¼Œææ¡)
HAYPOCRATES		å¸Œæ³¢å…‹æ‹‰åº•
unto 			=to
churn			æ…æ‹Œã€‚	The village full of churning bodies circulates.	æ•´ä¸ªé•‡å­é‡Œå……æ»¡äº†è½½æ­Œè½½èˆçš„èº«å½±ã€‚(circulate,ä¼ æ’­æµé€šã€‚)
snarl			å’†å“®æ€’éª‚ã€‚
bat away			è½°èµ°ï¼Œé©±èµ¶å‡»æ‰“ã€‚	I bat away a few ponies before they can grab some cupcakes and interrupt this little â€œmeetingâ€ of ours.	æœ‰å‡ åªå°é©¬è¿˜æ²¡è¿‡æ¥å–è›‹ç³•æ‰“æ‰°æˆ‘ä»¬çš„â€œå°å°ä¼šè®®â€ï¼Œå°±è¢«æˆ‘ç²—æš´åœ°æŒ¥ç€è¹„å­è½°èµ°äº†ã€‚
take the cake		éå¸¸è¿‡åˆ†ï¼Œè¿‡å¤´è¿‡ç«äº†ã€‚	This sort of stuff takes the cake!
double take		n. å¿ƒä¸åœ¨ç„‰åçªç„¶æ³¨æ„è€Œæç„¶å¤§æ‚Ÿã€‚I do a double take. 	å¥½ä¸€é˜µå­ï¼Œæˆ‘æ‰é†’æ‚Ÿè¿‡æ¥ã€‚
permeate			æ¸—é€å¼¥æ¼«ã€‚per-é€è¿‡ã€‚meat-=mea-=meateï¼Œç©¿è¿‡ã€‚	It is still bearable, but the agony permeates everything.	æ€»ç®—æ˜¯èƒ½å¿å—äº†ï¼Œä½†ç—›è‹¦å´æ¸—é€äº†æ‰€æœ‰çš„ä¸€åˆ‡ã€‚
pounce 			çŒ›æ‰‘çªè¢­ã€‚è¯æºåŒpuncture,punch.punct-é’ˆæ‰ï¼Œæˆ³åˆºã€‚	 I pounce on the first pony I see in downtown.	æˆ‘æ‰‘å‘æˆ‘åœ¨é•‡ä¸­å¿ƒçœ‹åˆ°çš„ç¬¬ä¸€åªå°é©¬ã€‚
*hyperventilating		ä¸Šæ°”ä¸æ¥ä¸‹æ°”ã€‚hyper-ï¼Œé«˜äº¢è¿‡åº¦æç«¯ã€‚
*whelp 			å°ç‹—å¹¼å…½;vä¸‹å´½ã€‚
*degenerative 		é€€è¡Œæ€§ï¼Œæ‹†è¯å³å¯
pentition			n/vè¯·æ„¿ï¼Œè¯·æ„¿ä¹¦ã€‚
knead			æ‰æ‰ã€‚æ‰ææŒ‰æ‘©ã€‚
scotch			è‹æ ¼å…°çš„ï¼›nè‹æ ¼å…°å¨å£«å¿Œ
demise			[æ­£å¼]æ­»äº¡ã€‚
*bushel			è‘¡å¼è€³ï¼Œå¤§æ¦‚42Lã€‚[å£]å¤§é‡è®¸å¤š			
pebble 			åµçŸ³ã€‚
canvas 			å¸†å¸ƒï¼Œæ²¹å¸ƒï¼Œæ²¹ç”»ã€‚æ¥è‡ªcannabiså¤§éº»=hempã€‚	I gulped  and searched for answers in the blank canvas staring back at me.â€œTwilight...?â€	æˆ‘åœ¨é¢å‰é‚£å¼ èŒ«ç„¶çš„é¢å­”ä¸Šå¯»æ‰¾ç€ç­”æ¡ˆã€‚â€¦â€¦æš®å…‰â€¦â€¦ï¼Ÿâ€
crud			æ¸£æ»“ï¼Œæ‚è´¨ï¼Œè„ä¸œè¥¿ã€‚å¯èƒ½æ¥è‡ªcurdå‡ä¹³ï¼Œä¹³çŠ¶ç‰©ï¼Œå‡ç»“ã€‚
limb 			*æ ‘æã€‚	I'm a limb cut off from the tree, forever a lost element.	æˆ‘æ˜¯ä»æ ‘ä¸Šç è½çš„å­¤æï¼Œæ°¸è¿œå¤±è½çš„å…ƒç´ ã€‚
palpitation		å¿ƒæ‚¸ã€‚é¢¤åŠ¨ã€‚æ¥è‡ªpalpitateå¿ƒæ‚¸å‘æŠ–ã€‚è¯æºåŒpulseã€‚	 I try to speak, but all that comes out are breathy palpitations.	æˆ‘è¯•ç€è¯´è¯ï¼Œä½†æ¯ä¸€æ¬¡å‘å‡ºæ¥çš„åªæ˜¯æ°”å–˜ååçš„å¿ƒæ‚¸å£°ã€‚
chronicle 			ç¼–å¹´å²ã€‚chronicæ—¶é—´->æ…¢æ€§çš„é•¿æœŸçš„ã€‚
trip			(æ—…æ¸¸)*ç»Šå€’ã€‚è¿™ä¸ªè¯ä¹‰æ¥è‡ªtrapçš„å˜å½¢ã€‚
backwater 		å›æµï¼Œæ­»æ°´ï¼Œé—­å¡çš„åœ°æ–¹ï¼Œä¸å—å¤–ç•Œæˆ–æ–°æ€æƒ³å½±å“çš„ç©·ä¹¡åƒ»å£¤å±±æ²Ÿæ²Ÿã€‚
asunder			adj/advåŒ–ä¸ºç¢ç‰‡çš„ï¼Œåˆ†ç¦»çš„ã€‚æ¥è‡ªsunderï¼Œvåˆ‡å¼€åˆ‡æ–­ã€‚	I want to rip her asunder.	æˆ‘æƒ³æŠŠå¥¹æ’•ç¢äº†ã€‚
pitch			*æ²¥é’->æ¼†é»‘ã€‚(éŸ³å‡†,æŠ•æ·)	 I flailedâ€”soaking wetâ€”rolling over leaves and grass in pitch-blackness.  æˆ‘æµ‘èº«æ¹¿é€ï¼Œåœ¨æ¼†é»‘çš„å¶å’Œè‰ä¸Šä¹±æ»šã€‚  pitch-blacknessï¼Œæé»‘ï¼Œæ²¥é’ä¸€æ ·ã€‚	Touch pitch, and you will be defiled. 	è¿‘æœ±è€…èµ¤ï¼Œè¿‘å¢¨è€…é»‘ã€‚	defileæ±¡æŸå¼„è„ï¼Œå³¡è°·éš˜è·¯ã€‚de-å‘ä¸‹å¼ºè°ƒï¼Œfileçº¿ï¼Œæ–‡ä»¶ã€‚
gnash	[nÃ¦Êƒ]		å’¬ç‰™åˆ‡é½¿ï¼Œå’¬ã€‚å¯èƒ½æ˜¯æ‹Ÿå£°è¯ã€‚	 I gripped my skull and gnashed my teeth, plowing my muzzle through the damp earth. 	æˆ‘æ­»æ­»æŠ±ç€è„‘è¢‹ï¼Œå’¬ç€ç‰™æŠŠè„¸åŸ‹åœ¨æ¹¿æ¶¦çš„åœŸå£¤é‡Œã€‚
infernal 			åœ°ç‹±çš„ï¼Œæ¶é­”çš„ã€‚æ¥è‡ªinfraåœ¨ä¸‹é¢çš„ä½çš„ã€‚
tendril 			å·é¡»ï¼Œè”“ã€‚	My limbs were the tendrils of a numb ghost.	æˆ‘çš„å››è‚¢ä»¿ä½›å¹½çµçš„å·é¡»èˆ¬éº»æœ¨ä¸ä»ã€‚
flounder			ï¼ˆå°¤æŒ‡åœ¨æ°´ä¸­ï¼‰æŒ£æ‰è¸‰è·„è¹’è·šç»Šå€’ã€‚I floundered for a hoof-hold.  æˆ‘æŒ£æ‰ç€æ”¯èµ·è¹„å­ã€‚
femur			å¤§è…¿éª¨ï¼Œè‚¡éª¨ã€‚æ¥è‡ªæ‹‰ä¸è¯­femurå¤§è…¿ã€‚	I  saw an endless sea of trees, all shining in the pale moonlight like bright femurs planted in the ground: just as sterile and lifeless.	æˆ‘çœ¼å‰åªæœ‰ä¸€ç‰‡æ— è¾¹æ— é™…çš„æ ‘æµ·ï¼Œè‹ç™½çš„æœˆå…‰ä¸‹ï¼Œæ‰€æœ‰çš„æ ‘æœ¨éƒ½åƒæ˜¯æ’åœ¨åœ°ä¸Šçš„ç™½éª¨ä¸€èˆ¬äº®ç€æƒ¨ç™½çš„å…‰ã€‚è´«ç˜ ï¼Œæ¯«æ— ç”Ÿæœºã€‚
sterile 			ä¸è‚²çš„è´«ç˜ çš„æ— èŒçš„ä¸æ¯›çš„ã€‚è¯æºster,å›ºå®šåšå›ºã€‚è¯æºåŒsternä¸¥å‰åšå®šã€‚
drip=dribâ‰ˆdropï¼ŒåŒæºè¯ï¼Œæ»´è½ã€‚
subtlety			å¾®å¦™ï¼Œæ•é”ã€‚æ¥è‡ªsubletå¾®å¦™çš„ã€‚letå°è¯åç¼€ï¼Œsubä¸‹/å°ã€‚	In time you'll appreciate the beauty and subtlety of this language.	æ€»æœ‰ä¸€å¤©ä½ ä¼šä½“ä¼šåˆ°è¿™é—¨è¯­è¨€çš„ä¼˜ç¾å’Œå¾®å¦™ä¹‹å¤„ã€‚	When I did, I didn't bother with subtlety.   æˆ‘å®åœ¨æ²¡æœ‰åŠ›æ°”ï¼Œé¡¾ä¸ä¸Šè®²ç©¶è‰è‰(ç”Ÿäº†ç«)ã€‚
agonizing 		ç—›è‹¦éš¾å¿çš„ã€‚æ¥è‡ªagony->agonize->agonizing
futile 			æ— ç”¨çš„ä¸é‡è¦çš„ã€‚fu-æµã€‚ä»˜è¯¸ä¸œæµ->æ— ç”¨ã€‚è¯æºåŒfuel(ç‡ƒæ–™)ï¼Œfuse(èåˆ)ï¼Œfoundry(é“¸é€ )
migraine			åå¤´ç—›ã€‚miæ¥è‡ªhemi-åŠè¾¹çš„ï¼Œcranå¤´é¢…->graineã€‚
relate to			æœ‰å…³è”->å¸®åŠ©,ç†è§£ã€‚	Spike gazed away, as if guilty for not relating to this infernal unicorn's frustration.	Spikeç«‹åˆ»ç§»å¼€äº†è§†çº¿ï¼Œå¥½åƒå› ä¸ºæ— æ³•å¸®ä¸Šè¿™åªé­æ®ƒçš„æ²®ä¸§ç‹¬è§’å…½çš„å¿™è€Œéå¸¸å†…ç–šã€‚
sovereign	    ['sÉ‘vrÉ™n]	å›ä¸»ã€‚è‡³é«˜æ— ä¸Šçš„ï¼Œæœ‰ä¸»æƒçš„æœ€é«˜ç»Ÿæ²»æƒçš„ï¼Œæå¥½çš„ã€‚æ¥è‡ªsove(superå˜å½¢ï¼Œåœ°ä½é«˜çš„)+reignç»Ÿæ²»ã€‚	Sovereign power will continue to lie with the Supreme People's Assembly.	æœ€é«˜ç»Ÿæ²»æƒä»ç„¶æŒæ¡åœ¨æœ€é«˜äººæ°‘ä¼šè®®æ‰‹ä¸­ã€‚
æ„è¯†åˆ°äº†å—ï¼Ÿhelp it å…¶å®æ˜¯å¿å—çš„æ„æ€ã€‚â€œI'm just so cold,â€ I murmured. I couldn't help it. I didn't want to help it.	â€œæˆ‘å¤ªå†·äº†ã€‚â€æˆ‘å–ƒå–ƒè‡ªè¯­ï¼Œå£°éŸ³ç»†ä¸å¯é—»ã€‚æˆ‘å®åœ¨æ˜¯å¿ä¸ä½äº†ï¼Œè€Œæˆ‘ä¹Ÿæ²¡æƒ³å»å¿ã€‚
snap			*æŠ±æ€¨/ä¸¥å‰ç²—æš´çš„è¯è¯­ã€‚(çªç„¶æŠ˜æ–­/å…³ä¸Š/æ‹‰æ–­çŒ›å’¬/å™¼å•ªå£°/çªç„¶çš„)
ensuing 			æ¥ç€å‘ç”Ÿçš„ã€‚æ¥è‡ªensueè¿½æ±‚;è·Ÿç€å‘ç”Ÿã€‚en-è¿›å…¥ï¼Œ-sueé¡ºåºï¼ŒåŒsequenceã€‚	 What will ensue from this?	è¿™äº‹çš„ç»“æœå°†ä¼šæ€æ ·?		 His ensuing grin was braver than anything.ä»–éšåéœ²å‡ºçš„ç¬‘å®¹æ¯”ä»»ä½•äº‹ç‰©éƒ½è¦å‹‡æ•¢ã€‚
*sappy hoopla		èƒ¡è¨€ä¹±è¯­ã€‚
portion 			ä¸€éƒ¨åˆ†ï¼Œ=partã€‚æ˜¯partçš„å˜å½¢ã€‚
peruse	[pÉ™'ruz]		ä»”ç»†åœ°è¯»ã€‚per-å®Œå…¨çš„ï¼Œuseä½¿ç”¨ã€‚æ¯”å–»ç”¨æ³•ã€‚	she murmured while perusing several scrolls mailed in from her homeland. 	å¥¹å–ƒå–ƒåœ°å›ç­”ï¼Œé˜…è¯»ç€ä»å®¶ä¹¡å¯„æ¥çš„å‡ å°ä¿¡ã€‚
*atrium			ä¸­åº­ï¼Œå‰å…ï¼Œå¿ƒæˆ¿ã€‚è¯æºåŒarsonçºµç«ã€‚æ¥è‡ªPIE*ater-ï¼Œç«ã€‚
nonchalant		å†·æ·¡çš„æ¼ ä¸å…³å¿ƒçš„ã€‚non-æ— ï¼Œéï¼›chalçƒ­çš„ã€‚è¯æºåŒcalorieã€‚antå½¢å®¹è¯åç¼€ã€‚
poker face		æ‰‘å…‹è„¸->é¢æ— è¡¨æƒ…ã€‚
*snare			é™·é˜±åœˆå¥—ã€‚è¯æºåŒnetç½‘ã€‚ä¹Ÿå¼•ç”³ä¸º
*jest			å¼€ç©ç¬‘ã€‚
forge			ç†”ç‚‰ï¼Œé”»é€ ï¼Œå‰è¿›ã€‚å¼•ç”³è´¬ä¹‰"ä¼ªé€ ã€‚"	Something melted across her face, a sweet smile forged by a dozen memories all flashing across her blue eyes.	å¥¹è„¸ä¸Šä¼¼ä¹æœ‰ä»€ä¹ˆä¸œè¥¿èåŒ–äº†ï¼Œé‚£åŒè“çœ¼ç›é‡Œé—ªçƒç€æ— æ•°å›å¿†æ„æˆçš„ç”œèœœå¾®ç¬‘ã€‚
*Nostalgia 		ä¹¡æ„ã€‚
baffle			ä½¿å›°æƒ‘ï¼Œä½¿å—æŒ«ã€‚næŒ¡æ¿/å›°æƒ‘ã€‚	But their presence here truly baffles me...	å¯æˆ‘å®åœ¨å›°æƒ‘ä¸ºä½•å®ƒä»¬ç«Ÿä¼šåœ¨æ­¤å¤„ï¼Ÿ
flippant			è½»ç‡çš„å˜´ç¢çš„ã€‚=flip(è¹¦è·³è½»å¼¹->æ— ç¤¼è½»ç‡çš„)
deem			è§†ä¸ºã€‚	 Experts deem it the most technically sophisticated tool ever found.ä¸“å®¶ä»¬æŠŠå®ƒçœ‹ä½œç›®å‰ä¸ºæ­¢å‡ºåœŸçš„æŠ€æœ¯æœ€å¤æ‚çš„å·¥å…·ã€‚
orthodox			æ­£ç»Ÿçš„ï¼Œä¼ ç»Ÿçš„ï¼Œæƒ¯å¸¸çš„ã€‚ortho-æ­£ç»Ÿçš„,åŸã€‚(orthogonalï¼Œæ­£äº¤çš„ï¼Œç›´è§’çš„ã€‚orthonormalï¼Œæ ‡å‡†æ­£äº¤çš„ã€‚)doxè§‚å¿µæ€æƒ³ï¼Œ(dogmaæ•™æ¡ï¼ŒdoctoråŒ»ç”Ÿã€‚)
seclude			éš”ç»ï¼Œåˆ†å¼€ï¼Œisolateã€‚se-åˆ†å¼€ç¦»å¼€ï¼Œ-cludeå…³é—­(è¯æºåŒcloseï¼Œconcludeä¸€èµ·å…³é—­ç»“æŸ->ç»“æŸ/å†³å®š/ä½œç»“è®ºï¼Œexcludeå‘å¤–å…³é—­->æ’é™¤åœ¨å¤–)	such a secluded zebraã€‚	è¿™åªéšå±…çš„æ–‘é©¬ã€‚
wondrous 		å¥‡å¦™æƒŠå¥‡éå¸¸çš„ã€‚æ˜¯wonderçš„å½¢å®¹è¯ã€‚
faraway 			é¥è¿œçš„ï¼Œææƒšçš„ã€‚		I must solemnly admit my dismay, for I have been committed to work and not to play. Why else would I be working in a faraway land if not to seek the mysteries of the world so that I may understand?	ä¸å¾—ä¸æ‰¿è®¤æˆ‘ååˆ†æ²®ä¸§ï¼Œæˆ‘ä¸€ç›´åœ¨å·¥ä½œæ— æš‡è¿·èŒ«ã€‚è‹¥éä¸“æ³¨å¯»æ‰¾ä¸–ç•Œå¥¥å¦™ï¼Œæˆ‘ä½•å¿…æ¥é¥è¿œå›½åº¦ç¹å¿™ï¼Ÿ
rendition			æä¾›å‘ˆç°çš„ä¸œè¥¿->æ¼”å¥ï¼Œè¯‘æ–‡ï¼Œæä¾›ã€‚æ¥è‡ªrenderã€‚	Zecora squatted across from me, her face eager and bright, just as I began my rendition of a ritualistic chant that I had researched long ago.		æ³½è”»æ‹‰ååœ¨æˆ‘å¯¹é¢ï¼Œè„¸ä¸Šçš„è¡¨æƒ…çƒ­æƒ…è€Œå¼€æœ—ã€‚è€Œæˆ‘å¼€å§‹æ¼”å¥ä¸€æ›²å¾ˆä¹…ä¹‹å‰ç ”ç©¶è¿‡çš„ä»ªå¼ç”¨åœ£æ­Œã€‚
render			å®æ–½/æå‡º/è‡´ä½¿/å‘ˆç°/è¡¨è¾¾ã€‚è¯æºåŒsurrender(åœ¨ä¸‹æ–¹+æä¾›->æŠ•é™)	The Board had been slow to render its verdict.	è‘£äº‹ä¼šè¿Ÿè¿Ÿæœªèƒ½ä½œå‡ºå†³å®šã€‚
ritualistic 			ä»ªå¼æ€§çš„ã€‚æ¥è‡ªritualä»ªå¼ã€‚










