derogatory		贬损的,offensive。 （rogat调查。rogation祈祷。）
grit 			verb研磨，n粗砂，勇气，坚韧。来自grind(磨碎，研磨)。grist(磨碎的谷物)也来自grind。
patio			露台。来自pete-展开，词源同patent(专利，新奇的明显的。愿意政府公文(取展开义)->专利；展开也引申为意思"明显/公开的")；词源同petal(花瓣)。
scuffle			扭打混战；拖着脚走路。来自scuff,磨损、拖着脚走。同shuffle。    I heard her scuffling hooves against the wooden stoop of my cabin's patio. 我听见她细碎的蹄声踏上我家小屋的门廊口。
stoop			v弯腰，弓着身子->n门廊。词源同steep(陡峭)。
porch			门廊，同stoop。
brick-laid			砖砌的。lay放置，铺。
dwindle			减少，变小。来自die。-le表反复/逐渐。   the flames of the brick-laid fireplace had dwindled to a dim glow. 
shingle（1）		木瓦，屋顶的瓦片；v用板/瓦片覆盖。词源为PIE*skei切，分开。如
shingle（2）		卵石滩。shing模仿水流过小石子的淙淙声，le表反复
drench			使湿透，n滂沱大雨。来自drink喝，引申为湿透。 The poor mare stood on my porch, drenched from head to tail.
beset 			v困扰、围绕、镶嵌。来自于军事术语be(强调)+set(放置)，指包围。
lousy 			讨厌的糟糕的污秽的多虱的。来自louse虱子寄生虫。(pl.lice)
placid			平和温和宜人的。来自please(愉悦)/placate(安抚)。
veritable 			名副其实的，的确的。来自very。  The world was a thick curtain of veritable waterfalls beyond her.她身后的世界如同瀑布一般。
sheen 			光泽。来自shine。
vestige			残余部分，遗迹。来自latin：vestigium脚印，足迹。词源同investigate调查。
*breather			[俚]短暂的休息
*monsoon		季风，(印度洋的)雨季， "trade wind of the Indian Ocean,"
fret 			焦虑烦躁。Don't you fret none. 你甭操心咱。
sly			狡猾的/淘气的。   I grinned slyly.我坏笑着。	
stoke			烧火，拨旺。来自stick(捅).    I dropped the new planks of wood at the base of the chimney and stoked the flame.几块木头被扔进烟囱下方，很快明亮的火光又一次温暖起整间小屋.
graft			嫁接移植。(引申为贪污)。词源同graph，carve(雕刻)
succinct			简洁的，简明的。suc-在下，-cinct,带子(cincture带子,环绕；pre-cinct街区)
*twang 	 [twæŋ]		鼻音。		
trek			n/v长途跋涉，来自track(轨迹，小道)
deluge			n/v洪水，泛滥。de-, 向下，离开。-lug, 冲洗，喷流，词源同lava, dilute.
quiver			n/v颤抖。词源同quake，qu-拟声词，模仿松软颤抖的声音。
pang			突然的一阵痛苦。
nemesis			报应，天罚。Nemesis，涅墨西斯，复仇女神。
*detritus			碎石岩屑，碎屑。de-消解，trit转，-us拉丁文名词后缀。
sparse 			稀疏的，稀少的。词源-spar
pore	 [pɔː]		小孔。来源于per向前->引申为孔洞。
porous			多孔的，能渗透的。
rustic			乡村的/粗野的。注意并不来源于rust锈，而是rural->rustic.
meager 			贫乏的，瘦的。
sparse			稀少的，稀疏的。词源为sper-(变形为spar,spr)播撒。如sprinkle，spread。 In the sparse beams of sunlight needling through the barn's porous ceiling beams I could barely tell the difference between my lyre and the random bits of farm junk surrounding it.稀疏的阳光从屋顶的细缝里刺下来，如此暗淡，让马分不清地上哪里是我的七弦琴，哪里又是谷仓里的其他破烂。
havoc 			大破坏，大骚乱。	
wreak			v发泄报仇。->诉诸，实施。来自wer(弯，扭曲)的扩大形式。
rave			咆哮，胡言乱语。 a raving pony wreaking havoc across town 一匹在镇上实施暴行的疯癫小马
subject			*使遭受。  being subjected to their rosy expressions—served only to remind me of how cold, hungry, and scared I was.  在她们善意的表情注视下，我只能更加想起自己多么冷，多么饿，多么怕。
tether			n范围，拴绳。v用绳拴住。
contemplate		冥思苦想，思忖。=muse。template，样板模板。
dilapidate			v毁坏，浪费。di-分开(dis的变体)，lapis-石头,引申为滑落。(如collapse)常用dilapidated荒废的。
*quartet 			四重奏。quar-4.
scrap			n碎片；v拆毁解体。是scrape的对词形式。scraping，n刮擦下来的碎屑。
scrape			v刮擦磨。	
chisel	['tʃɪz(ə)l]		雕刻，凿。来自词根cid或cide砍劈(死)，如decide，suicide。
soothe			安慰。sooth(抚慰)的动词形式。
adorn			v装饰。ad-去，往。orn装饰。见ornament(n装饰)
taste buds 		味蕾(品尝的 芽)
*nelly			女人气的男人,int.
appease 			安抚。a-动词前缀，peace平和。ap-peac(s)e-->appease安抚，使平和。
gnaw   [nɔ]		咬，折磨。拟声词。"闹"咬东西的声音。
refuse			*垃圾(v拒绝)
bob			n/v上下跳动，震动。
crest 			波峰，山顶。词源同crisp卷的，卷羽->长在头上->顶峰。
drape			用布覆盖，悬挂，呈褶皱状垂下。"ornament with cloth hangings,cover with drapery(布料，帷帐)."    I fought for an even breath, draped across her spine. 我趴在她背上，有些困难地呼吸着。
*panic的过去式是panicked。有时panic也会写作panick。
bale			包，捆，打包。词源同ball球，膨胀/鼓。
fray			v/n争论，磨损，使人紧张急躁。词源同afraid害怕，friction摩擦力(小f)  This kind of living was beginning to fray her nerves. 这种生活开始让她神经紧张。
frazzle			同fray，磨损,使疲惫。 I ran a hoof through my frazzled mane and stifled my whimpers before they could form. 我有点结巴，用一只蹄子梳理一下自己的磨破的鬃毛，抑制住自己，继续说道
tousle			n/v(使)杂乱，凌乱。
immaculate 		洁净无污的。来自maculate弄脏，使有污点；来自mark->mac斑点记号。
*sponge up		用海绵擦拭吸取液体->引申：白吃白喝，在一个人身上占便宜。
blurt			未加思索地脱口说出。
hearth 			灶台，壁炉地面。(引申 策源地，中心，家庭)，词源同habit。
*goose bump		鸡皮疙瘩。(因类似鸟皮肤上的小疙瘩得名)
emaciate			使消瘦。emaciated，虚弱的。很书面的写法。e-向外，-mac瘦,长。见词根macro-，大，宏观(负面的"大"，虚大，消瘦的大)。同源有meager(少量且劣质的)，macro-cosm(宏观世界)，macroeconomics宏观经济学。
*vagabond		流浪者。vag-漫游。拉丁语bond名词词缀。
*bum			流浪汉，=vagabond。拟声词，屁股落地的声音。
impoverished 		=poor，穷困的。是imporverish的形容词形式。im-进入(状态),-pover(见poor.poverty)
huddle			挤在一起，蜷缩。词源同hide，le表反复，引申为蜷缩。 I huddled into the deeper contours of the sofa. 我缩到沙发的更深处。
contours 			n/v轮廊，画轮廊线。con-强调；tour,转(引申旅游)。词源同turn。
rummage			n/v翻找，翻箱倒柜地找，找出的杂物。rum-屋子，同room。-age，名词后缀。 she swiftly trotted towards a closet, opened it up, and rummaged through rows of hanging jackets inside. 她转过身向衣柜跑去，在里面挂着的一排外套里翻找起来。
*modicum 		少量，一点点。-um是拉丁语表中性的后缀。mode模式，方式，尺度。ic形容词后缀。
masculine			男性的，雄性的。来自拉丁语masculus。-us是拉丁语中表阳性的suffix。
encase			包住。en-进入，case箱子。
engulf			=gulf,吞。
*toasty->toastily		像烤面包似的->暖和舒适的。
hitch			*麻烦，故障挫折(钩子，钩住)go without a hitch 顺利进行，没有间断。
frail			脆弱的虚弱的。是fragile的省略。
*jiffy			[俚]一会儿。词源不详。said to be originally thieves' slang for "lightning."
nocturnal [nɑk'tɝnl]		夜的。nuct-夜间的，-urn和-al是形容词后缀。noctilucent，夜光。
*frag			蓄意杀伤，手榴弹。since1970的军队俚语，fragmentation grenade破片手榴弹的缩写。
psyche ['saɪki]		灵魂，心智。
fitful			断断续续的，一阵阵的，不稳定的，颠沛流离的。 by Shakespeare 的造词("Life's fitful fever," )  “Who does it belong to?” I glanced up at the shoddy, wooden structure where I had spent the last two fitful nights.  “这个谷仓是谁的？”我抬头看着那破旧不堪的木头谷仓，那个我颠沛流离地住了两个夜晚的地方。
meditate			考虑沉思，冥想。
recess			休息，间隙凹处。an undying tune that had been born in the recesses of my mind  在我的心灵 深 处 诞生的一种永恒的曲调。
bow			*蝴蝶结🎀(弓)
muster			聚集，激起(支持，勇气)，煽动，集合人群，集结部队。I said in as gentle and harmless a voice I could muster.  我 用 自己最温柔无害的声音说道。
saucer			茶托，浅碟子，(比喻)眼睛。来自sauce调味汁->容器saucer。 The girl back-trotted from me, her eyes as wide as saucers. 面前的小姑娘往后退去，眼睛睁得和盘子一样大。
iris	 ['aɪrɪs]		虹膜。来自希腊语iris,彩虹。 a pale sheen danced across her irises.,like moonlight rippling over pond water. 她的瞳孔周围闪着乳白色的光芒，像是月色反射在池水上一般。
ripple			n波纹，涟漪；v荡起涟漪。
commotion		骚动，暴乱。一起行动->暴乱。
*rambunctious 		难控制的骚动的粗暴的喧嚣的。是rumbustious的变形。rum-强烈的(或朗姆酒),bust爆发。-tious形容词后缀。
vandalize			肆意破坏践踏。vandal，破坏者，adj破坏性的。The term vandal commemorates a Germanic tribe, the Vandals, who sacked Rome in 455 AD, and thereby earned themselves a reputation as destroyers of civilization. 来自拉丁语Vandalus,日耳曼部落名，于公元455年将罗马洗劫一空，因而引申该词义。
*mayhem			故意伤害。may-力量，劈砍(同might，mangle)引申为伤害。
trespass			n/v入侵，打扰冒犯。tres-是trans-的变形，远处"beyond".pass来到。即冒犯。
*quadru-ple		四倍。quadr-4，ple倍数。同triple。		
grimace			扮鬼脸。来自grim咆哮+face，咆哮的脸
dwindle			减少变小。来自dye死亡。le表反复。Their shouting voices dwindled as I shot around a corner and bolted for the front door. 我狂奔过一个角落，向前门跑去，她们的叫喊声在身后渐渐小了下去。
muse缪斯，音乐女神；v顿悟。->music音乐。
reel			v/n卷，蹒跚眩晕。 I fell down on my haunches, reeling sickly.   我一屁股坐到地上，头昏脑胀。
menace  ['mɛnəs]		威胁恐吓。 
delectable 		美味的，令人愉快的。词源同delic-ious，美味的。delectate，取悦。
*Minotaur		米诺陶洛斯，人身牛头怪物，来自拉丁语Minotauros.
grit			研磨->咬紧牙关；砂砾->勇气，决心。来自gri-磨。词源同(grind(研磨);ground(地，在地上磨))
tile			瓷砖瓦片。
pensive			沉思的，哀伤的。词根是pend-，悬挂。和pend(v沉思,悬而未决)，depend(悬挂->取决于，信赖依靠)同源。
debacle 			崩溃，灾害。de-分解.
quilt			被子。
unkempt  [,ʌn'kɛmpt]	蓬乱不整洁的。kemp是comb的异体，已废弃。所以unkempt=uncombed。
pouch 			小袋。I immediately flung them into the front pouch of my hoodie.  我拿起来塞进自己的兜里。
luscious 			精致的美味的。来自lust热情色欲欲望。
*chipper 			切东西的工具->爽朗开心爽快。 but seein' as I'm feelin' mighty chipper this mornin', how'd you like a two-for？不过今天早上咱心情好，你觉得买一送一怎么样？
pilfer			小偷，偷窃。 He pilfer from a cash register. 他偷收银台里的钱.
glum			阴沉忧郁的。是gloom的变形。
dissipate			浪费，消失。dis-分开远去；-sip扔，分散。 my shivers dissipating somewhat.  寒冷不知为何渐渐消散了。
*shoddy			赝品，冒牌货，劣质的。
shred			碎片，撕碎。来自PIE*sker,切，劈，砍。同源:shard(碎片=shred)
splinter			碎片。来自splint木条，板子。<--来自split分开劈开。
*splintery			破碎的。
*sarcophagus		石棺。   like the accursed treasures of a splintery sarcophagus. 像古代墓穴里中被诅咒的宝藏一般。
snicker			窃笑。是士力架的英文		
affectionate 		深情的。affection喜爱。  I gazed up at the structure, running an affectionate hoof across the doorframe.  我抬起头，一只蹄子轻轻抚摸着门框
nifty 			俏皮的漂亮的。可能是magnificent的口语？？
*gander 			雄鹅->瞥一眼，闲逛。  take a gander看一看=take a look
“Right. Figures...” “也对。早想到了……”
pitch			v抛扔->扎营，搭帐篷。  n沥青，音高，程度，投掷，倾斜。It was obviously the same wooden barn she had trotted past every morning on her way to town, only now there was a green tent pitched next to it.   明显还是那个她每天早上到镇里的路上都要经过的那个谷仓，只是现在谷仓边多了一顶绿色的小帐篷。
tarnation			讨厌，该死。是damnation->darnation的委婉语。  What in tarnation...? 这是怎么了……？
circus 			马戏团。(圆形引申)
minstrel	['mɪnstrəl]		歌手，艺人，吟游诗人。来自minister仆人的变形。
*scrumptious		[口]美味的极好的。scrum扭打混乱。
lurch			蹒跚地前进，摇晃着走。词源同lurk(潜伏)
goggle	['ɡɑɡl]		n护目镜，风镜，眼睛睁视,v瞪眼看。 gog，象形词。
demolition		拆迁，破坏。=demolish-ment. 来自demolish，v拆除。de-下降，mol-大块，建造。和mole(物质的量单位摩尔，鼹鼠，小块儿)，molecule(分子)同源。
yank			猛地一拉。
grunt			嘟囔，咕哝，哼唧。拟声词。
gab			瞎扯空谈。拟声词。
A spectral bolt of lightning	一道彩虹色的闪电。  spectral，光，光谱的，幽灵的。来自spect观察。
disassemble		拆开，解开。dis反，分开+assemble集结。
lumber			木材。v伐木。可能来自timber的t-l音变，类似language-tongue。
*reenact			再制定，重新制定。由于react这个词被"反应"占用了导致的吧。	
Applejack stifled a guffaw.  Applejack强忍住笑意。 stifle窒息，guffaw笑。
*thwack	 [θwæk]		强打重击。拟声词。"to hit hard with a stick"		
snarl			n/v咆哮
hack			v骇客(非法进入)，砍劈。
tingle			v感到刺痛。n刺痛。和sting同源。ting是拟声词根，表示刺入。
stinging			激烈的。(sting刺入。)
*dang 			[俚]damn
dainty 			美味的秀丽的。挑剔的。是dignity的变体。
chisel			雕刻，凿，来自cid-砍劈。同decide，-cide(杀)，incise（切，劈砍）。
incision 			切口，切开。来自incise。
perpendicular		垂直的。per-,整个的，-pend,悬挂，词源同depend。引申词义垂直的。
*gawk 			呆子，呆呆地看。
notch 			V字型槽口，峡谷，砍。
meditate 			考虑深思。来自mid中间的。在其中->陷入其中，沉思。
precarious		危险的，不稳定的。
hatchet			短柄小斧。-et小词后缀。
clearing 			*n林间空地。
if you catch my drift.   懂我的意思吧？drift漂流(比喻说法，飘过来的想法?)
Care to spot me?		帮我看一下如何？spot me,帮我看着。
beam 			*木头梁子。(光线)  Just don't forget to apply the mortar between the beams. 只是不要忘记在梁之间涂上灰泥。
*scaffold			脚手架，临时搭建的平台。
plaster			石膏，灰泥；v涂抹，粘贴。和paste(粘贴)，plastic(热熔塑料)，plasma(血浆，等离子体)是同源词。来自plas-，铺平的。  Together, we finished plastering mortar inside the upper beams of one the cabin's completed walls. 小屋一面内墙上的房梁在我俩的合作之下已经勾好了砂浆。
*tarp 			油布，防水油布。
he gazed off into the wintry lengths of the forest. 他凝视着远处寒冷的森林。
heap			v/n堆，堆积。
smudge 			v弄脏，n污点。=smut=smutch。可能来自mud泥巴。
verge 			n/v边缘，濒临。词源同edge，ledge( 窗台边缘)，边缘:verge，edge，ledge，brink。
megaphone 		扩音器。mega-大。
swivel			旋转，使旋转。来自词根swei-旋转。同源词有spin
旋转rotate,wheel,spin,revolve,round,twist,whirl,twirl,swivel
*tan			褐色，黄棕色。
shoot			*嫩芽，枝条。(射击)
scion ['saɪən]		幼枝，接穗，子孙。
dwarf	[dwɔrf]		矮子侏儒。
*mascot			吉祥物。来自mask面具。
hue 			色彩，外表，叫声。She smiled as she gazed once more into the soft red hue of the fire.   她再次看着壁炉里跳动的红色。
erect 			v/n建造，竖立，直立的。you learn more about the process as you erect the walls and rooftop for the very first time.  当你第一次建造墙壁和屋顶时，你会更多地了解这个过程。
billow 			n/v巨浪，翻滚。 I felt a cold wind billow through the cabin, though not a single window was open.  即使没有开窗，我依然感到寒风从屋里吹过。
*munch			咀嚼，吃。 （拟声词）
*meth			冰毒=甲基安非他命=甲基苯丙胺=甲安非他明。
coax			哄骗。=hoax。coax和hoax可能来源joke。
anecdote			奇闻轶事。an-没有。(如amnesia失忆症)，ec-=ex-向外。don-给与。(donate捐赠)an-ec-dote，没有向外给出过的->奇闻轶事，秘史。
fiddle			n/v小提琴。->瞎搞,虚度光阴。 由于拉小提琴的时候手会不断地摆动、移动，所以后来转为贬义后就引申为“不停地摆弄、瞎摆弄、瞎搞”，甚至进而引申为“鬼混，闲荡，虚度时光；欺骗，欺诈，诡计，不法行为”等含义。含义基本上都引申为趋于贬义化了。		Dad stands in the middle of it, fiddling with his latest painting.	爸爸正站在轻风中，琢磨他最新的那幅画。
purse			*皱，嘟嘴。(小钱包)
scoot			n/v溜走，疾跑，轻便摩托车。scootaloo，小鸡璐。可能来自shoot?
