fixation			固定->用于心理学，迷恋，癖好. He's got this fixation with cleanliness. 他有洁癖。
predicament		状态，窘况困境。来自predict预言预测。  Believing in some sort of purpose is what keeps me going, what keeps me banging my head against the thick wall of my predicament. 相信有其目的存在，乃是我一次次在困境的南墙上撞得头破血流却依然不知退缩的原因。
chirp			n/v叽叽喳喳叫(拟声词)
*mug			马克杯。
smite			n/v打击；使神魂颠倒。I think someone's smitten with you, Pinkie.  我想有谁迷上你了，萍琪。
*custard			蛋奶油。蛋奶沙司。cust来自crust面包屑。
*strudel			以果实或干酪为馅而烤成的点心。
relinquish			放弃，放手。 "desert,abandon,ditch"  They will never voluntarily relinquish their independence.  他们绝对不会自动放弃独立.
resolve			n决心，决定。v下决定->解决->分解解体(dissove)/(炎症)消退  My days now are filled with tranquility, purpose, and resolve. 
*damnation 		n. 罚入地狱，遭天谴。
merit 			n优点价值，v值得。   what is the power of damnation without a slice of hope to merit its potency?     毕竟，如果没有一丝希望来(反向)证明它的作用(potency)，诅咒的力量又如何体现呢？
*anchor-age 		n锚地。来自anchor锚。  Every breath and song and sob holds anchorage in my throat and mine alone.  每一次呼吸，每一首歌曲，每一声哭泣，都发自于我的喉中，只发自于我自己。	
desolate			荒凉的。deslation--n废弃。de-向下，强调。sol-单独的。
surly 			乖戾的无理的傲慢的阴沉的敌意的。改写自sir (读音亦如是)，先生，领导，比喻用法。
*sorcerer 	['sɔrsərɚ]		巫师，男巫。来自sorcery，巫术。来自sors(命运，抽签抓阄)-ery
*get-together		[口]聚会。
phantom 			幽灵。  phantom limb幻肢
specter=spectre=spectrum	幽灵。 (spectrum还有光谱的意思)
lop			砍，剪树枝。  I feel as though a phantom limb is speaking to me, that something lopped off my soul is screaming to be reattached, only to remain a numb spectre of something warm and irrecoverable.   我感觉仿佛有什么缺失的东西在呢喃，就像是幻肢感？为什么从我灵魂中剥离的东西在尖叫着要重新回来，却依然只是温暖而不可触及的幻像？
veritable 			真正的，名副其实的。来自very(正是)
obsession			痴迷，[心理]强迫症  Twilight Sparkle had treated her career like a veritable obsession.     但暮光闪闪却真正痴迷在她的职业之中了。
apt			适宜的。恰当的。来自词根ap-，连接。->合适的。(co-up-le一起连接->一对儿；ad-apt，去-连接适应->适应，改编;ad-ept，ept同apt，去-连接适应->熟练的擅长的，内行)
commune		v密切联系，融合为一体,n市镇，社区。community来自commune。  There are ponies here with whom she's had the opportunity to commune.   在这里她可以和居民们尽情沟通，交流。

I've lived long enough to know that life is the sum of its days, and yet the flavor of its dreams.    我已经活了够久，知道这样的日积月累，便是生活--然而，也是梦想和憧憬所在。

scour			冲刷，擦洗。*引申为浏览。  I'll be scouring the texts for any tiny bit of info that can clue me into the magical secrets behind Nightmare Moon.   我会埋进文字堆里苦苦寻找任何可能的蛛丝马迹，可以让我了解梦魇之月背后的魔法秘密。
eke 			竭力维持，勉强维持。常用eke out：   They eke out a precarious existence foraging in rubbish dumps.    他们靠在垃圾场捡垃圾维持着朝不保夕的生活.     attempting to eke beauty from the fringe of the wilderness around me 勉强从包围着我的荒野边缘守住自己的优雅.
entry			*条目。Every ten journal entries or so, I ask the same question。大约每十篇日记，我都会问相同的问题。
rhetoric	 ['rɛtərɪk]		n修辞。adj花言巧语的。来自rhetor，公众演讲者(古希腊语)。词源同rhythm(rhet->rhyt，表示韵律。)       His rhetoric sounds like the death rattle of a fading leadership.  他的慷慨陈词听起来像是一个衰落的领导层垂死的挣扎。
carousel 			机场传送带，旋转木马。来自词根cur, 跑动，词源同car ,chariot, current.
consecutive 		连续不断的。con-强调。sec连接。(词源同sequence(序列))，utive形容词词缀。同consistent，continuous。     The same squirrel has crawled up to me for the fifth consecutive occasion.  同一只松鼠已经是第五次爬到了我身边。
morsel 			一口，小块(食物)。来自拉丁语mordere(咬)，词源mord-同mordant(腐蚀性的)，remorse(向后咬->懊悔，比喻用法。)
in a row			连续地。
*whimsy			怪念头怪想法。可能是拟声词(风的声音)，就像whimper(啜泣)。whinny(马嘶声)
funnel	['fʌnl]		漏斗。来自-fund，注入。如fund(基金)，foundry(铸造)
tuning fork		音叉。
just short of screaming.	就差叫出来了；只是没有尖叫。
palpable			明显的，可感知的。来自palpate,接触。词源同palpatant(颤抖的悸动的)，palpae(触须♂)。
percussion		震动碰撞,打击乐器。来自cussion(冲击碰撞)。如concussion,冲击震荡,≈precussion
*capella			 [天] 五车二（御夫座之一等星）。清唱。
so long as I have joy to perceive,    只要我还能感觉到快乐，
perch			n/v杆子，栖息，高位。   We watched the parade from our perch.  我们从高处观看游行.     The bird took its perch.   鸟停歇在栖木上.
scurry			疾跑。hurry->scurry。来自hurry的韵律重复构词。   He winced at the sight of a scurrying spider and brushed loose a few flimsy cobwebs.   他先是被一只飞快溜走的蜘蛛吓了一哆嗦，然后掸掉了书上覆盖的一层薄薄的蜘蛛网。
brandish 			挥舞。来自brand(铭刻于，商标牌子。)
The jury's still out on...	 ...仍没有定论。
detest			厌恶憎恨。de-向下强调，-test见证。词源同contest争辩(找人来作证的)；attest证明；test(证明->考察考试)
eclipse			日蚀/月蚀。ec-向外，-lipse留下。
*abduct			诱拐，绑架。来自ab-离开，duct-拉，牵引。
Aloe 			芦荟，龙舌兰。
Lotus			莲花
frivolous 	 ['frɪvələs]		无聊的，轻佻琐碎的。可能来自fri=fray磨损争论。
pedicure			足疗，v修脚。来自pedi-脚，cure治疗。
massage 			n按摩。来自PIE*mag揉捏，同源词有make(制作)，mass(块儿，聚集)。  she needed far more than a frivolous massage or pedicure.   她所需要的的远不止是一场无聊的按摩或者足浴。
*elation			兴高采烈。不知为何，你好像天生认识这个词。
identical 			完全相同的。
ritual			n仪式。adj仪式性的。来自rite，n仪式习俗。    This was my fifth identical conversation with Twilight Sparkle, and I was only just then getting used to the whole ritual.   这已经是我和暮光闪闪第五次进行相同的对话了。我才刚刚习惯了这一切。
aroma			芳香。aroma=fragance=perfume=scent=bonquet=odour
ethereal 	 [ɪ'θɪrɪəl]		天上的，神性的。像空气一样的。来自ether乙醚(苍天。这是因为乙醚极易挥发而取的名。)   
theorize	['θiəraɪz]		推理，建立理论。     I think... or at least I theorize.我这样想....或者至少是这样推测的。
reticent 	['rɛtɪsnt]		沉默的，保留的谨慎的。re-表示抑制。词源为拉丁语tacere安静。如tacit=reticent。
tacit	['tæsɪt]		沉默的，保留的谨慎的。	
vague 			模糊。
stifle			窒息压制扼杀。可能来自于stiff(僵硬坚决严厉)。来自词根ste-/sto-/stu-/sti-塞紧打包。如stifle窒息压制；steep陡峭的；stiff僵硬的；stoop弯腰；stuff塞进填充(物品玩意儿)；
herring			鲱鱼。来自hoar(灰白色。)       red herrings红鲱鱼，指代转移注意力的话题。	
It's taken me several months, and I am only barely scratching the surface of history's forgotten answers—assuming that they are indeed answers, and just not red herrings disguised by the obscure layers of time. 
足花了几个月时间，我只不过是触及了被历史遗忘的答案上面那层厚厚的尘埃而已。这还只是假设它们是答案，说不定我费尽千辛万苦之后，只发现我追寻的只是因为时间磨损而模糊的混淆而已。	

despot 	['dɛspɑt]		专制君主，暴君独裁者。de-表强调，pot-力量，如potent有力的有权势的。
sentient	 ['sɛntɪənt]	有感觉的有感情的。来自sence。

bane			毒药，祸害。来自gun枪。
labyrinth 			迷宫。laby来自lobby大厅。  labyrinthine迷宫般的。-ine是形容词后缀。
depict			描述描画。来自de-向下，-pict画(picture)。即画下，描绘。
*cyclone			旋风🌀。来自cycle，圈。-one，大词后缀。
uncanny			神秘的离奇的可怕的。(不能做到->无法触及，神秘。)来自canny，能干的。来自can，能。
heinous   ['henəs]		可憎的凶恶的。来自hate。同hatred
relish			v欣赏，品味；n滋味风味。
trepidation		恐惧忧虑颤抖。来自trep-颤抖摇晃。同源词有trepid(不安的颤抖的)，tripdant(颤抖的)，tremble(麻烦)。也可能来自词根ter-旋转/摇晃。
sap			n精力，元气活力，坑道；v挖掘破坏，挖地道，使伤元气。
*fetlock			n. 距毛（马蹄后方的丛毛）；球节（生距毛处）

cap:超人披风。
cloak:斗篷。
mantle:有袖子的斗篷。

dew	  [du]		露水。和drop是同源词(流下)。morning dew晨露。
annihilate	   [ə'naɪəlet]	v灭绝歼灭。an-同ad-去，词根nihil-零。如nihility，虚无。nihilism，虚无主义。
paranoid			偏执狂，偏执妄想的。来自paranoia偏执妄想症。-ia是疾病后缀。oid-类，像，词源同android(安卓，字面翻译"人一样的").    I became nervous, paranoid, and easily frightened. 我开始变得紧张，多疑，容易害怕。
*bolero			西班牙的）波列罗舞，波莱罗舞曲。
mortify			禁欲苦修拘束羞辱。来自拉丁语mors，死。词源同nortal终有一死的，murder谋杀。
*grandiose		=grand宏伟的。
impetus			动力，冲力。词源同impact(冲击)。
retain			保持，雇佣，保留获得。re-加强。tain保持，同maintain。   He decided to retain him for the trial.   他决定聘请他为出庭律师。  I was retaining more knowledge than even poor Princess Luna herself.  我领悟的知识甚至比当时可怜的露娜从中亲身领悟的都要多。
dissonance		不和谐的音符，不一致。来自son-声音。sonant，有声音的；sonal声音的声速的...
lift			*(诅咒/禁令)解除。 My curse certainly wasn't being lifted with any of my subsequent performances.  我的诅咒当然也不会随着我的任何演奏而解除。     making them do anything with the simple promise of lifting the very effects of the tune.      这样的暴君可以让他们言听计从地服从于她，只要她简单地承诺解除这首曲子的影响就足够了。
harrow			v耙地，开拓，->使苦恼。 The ox is never woe , till he to the harrow go.   牛不耙地不知苦.
harrowing		痛苦的悲惨的。 You've had a harrowing time this past month.  过去的这个月你过得太痛苦了。
guile 			n狡猾，欺诈。"deceit, wile, fraud, ruse, trickery." （有时引申为戒备、耍聪明。）  It turned out that my guile was almost for nothing.The fifth elegy resulted in a very comforting experience.      结果事实证明，我的戒备几乎是白费了力气。第五首挽歌的结果是非常舒畅的。
mimic			模仿。来自mime哑剧滑稽戏模拟表演。
*Anthem 			赞美诗歌曲。
none other than 		不是别的，而正是...(加强语气)     It was none other than the Anthem to the Lunar Empire.    这曲子不是别的，正是“明月帝国赞歌”。
usurp	[ju'zɝp]		篡夺篡权。来自use使用。use变形为usu，rp-抓住，如rapture(狂喜，来自rapt全神贯注的(精神被抓住的,比喻用法))。       the dark alicorn attempted to usurp the power of her sister.    黑暗天角兽企图篡夺她姐姐的力量.
insidious			阴险的隐伏的。in-进入，使；-sid-坐下，词源同(sit坐;seat座位;)。在里面坐着->潜伏着。  even the most insidious of tools we invent in this world all start as a noble work of art. 就算是我们在这个世界上创造出的最阴险奸诈的工具，都是从一样高贵的艺术杰作发源的。
nefarious	 [nɪ'feərɪəs]	邪恶的穷凶极恶的。来自ne-无，没有；fas-公理.词源同fate.->无公理的，不法的。	inexplicable 		无法解释的,费解神秘的。来自explicit(adj清楚明白的)，explicate(v解释清楚)
blemish	  ['blɛmɪʃ]		n瑕疵污点，v玷污。词源同bleach漂白。   This is the one blemish on an otherwise resounding success.    如果没有这个小小的失误，这就是一次彻底的胜利。	The blemish is gone. Where is the Mare in the Moon...?		上面的阴影哪儿去了？囚月之马呢……？
impressionable		敏感的，易受影响的。来自impress影响。
warmonger		好战者，战争贩子上面的阴影哪儿去了？囚月之马呢……？，主战论者。来自monger商人贩子。词源同merchant。
zealot			狂热者，犹太教狂热信徒。来自zeal热情。

the likes of sb/sth [informal]     (尤指被视为和某人或某事物一样好的)种类，类型.     When I first played the “Sunset Bolero,” I was pleased to not experience a wave of uneasiness the likes of which the Prelude afflicted me with.	当我第一次演奏“余晖波莱罗舞曲”之际，之前在序曲中折磨我的那种战栗和不安再也没有出现过，真让我开心不已。	She didn't want to associate with the likes of me.	她不想与我这种类型的人交往。
unravel			解开,阐明,解决。来自ravel，n纠结，错综复杂的一团。(ravel也可作动词=unravel。词义的矛盾性可能是来自碎毛线 一松开就缠绕在一起。)	 I've hoped to be many things at the end of unraveling this curse, but dead isn't one of them.    我的确希望在解开这个诅咒的最后会有很多情况发生，可绝不希望其中包括死亡。
treacherous    ['trɛtʃərəs]	奸诈的背叛的危险的。来自treachery背叛不忠，来自trick。-ery表行为。
foliage	       ['folɪ ɪdʒ]	植物，叶子(总称) "representation of leaves or branches"。和foil(薄片，衬托，阻止)，leaf同源。    I was utilizing every bit of stamina in keeping myself from passing out in the middle of that dense foliage.	我现在正挤出浑身上下的每一滴耐力来防止自己晕倒在茂密的枝叶间。
pass sth.  off		冒充某物。 He tried to pass off his friend's idea as his own.他试图把他朋友的点子说成是他自己的。
in and of itself		跟in itself意思差不多:本身，就其本身而言。   It's a feat in and of itself to pass my condition off as a temporary illness.    如果要把我现在的状况当做小毛病，那简直就是在完成一项壮举。  	That stress in and of itself is actually good.   压力本身其实是件好事。
speck			斑点污点。=stain, spot, taint, blot, mark, smear, maculation, smudge, blotch, blemish, smirch。		
steward	['stuɚd]		管家，乘务员机组。-ward看管看护。(ward病房，监视)
syringe     [sɪ'rɪndʒ]		注射冲洗，吸管/注射器。inject/injector。injector可以看成升级版的syringe(指那种可能有自动/液压装置的精确填充的user-friendly的笔外观的那种一次性注射器，类似肾上腺素笔。)
*permafrost		永冻土。自己拆吧      I'd be warmer if I gathered a syringe full of permafrost and shoved it into an open vein.   	如果我把永冻冰层的冰水注射到我的血管里，说不定我还会感觉更暖和呢。
dissect			切，解剖，详细分析。dis-分开，sect剪。同section，segment。
tribulation		痛苦。可能来自tribute吊唁致敬->痛苦？(tribe部落，来自tri-三，be-存在)      It was a noble goal, and it was worth all of the trials, tribulations, and shivers... most of the time.	这是一个崇高的目标，所有这些考验、磨难、颤抖……全都值了。……至少是大多数时候吧。
threshold	      ['θrɛʃhold]	阈值，门槛，开端，极限，临界值。来自thresh(推敲，打。)	We are on the threshold of a new era in astronomy.	我们很快就将迎来天文学的新纪元。	I clung to myself, shivering upon the threshhold.	我支撑着身体，在门前颤抖。
concoct			混合制作，捏造，图谋。concoction混合物。  con-强调-coct是cook的变体，即放在一起煮的-.混合熬制。 	She stood over a bubbling cauldron, squinting at a series of herbs that she was sprinkling over a new and experimental concoction. 	她正站在一口冒泡的药锅前，眯着眼睛检查着一系列用来制造新实验药品的草药。
icicle			冰柱冰坨子。
reagent			试剂，反应物。这来自react反应和agent(药剂)。
*ram			山羊，白羊星座。
*broth			肉汤，液体培养基。和brew(酿造,药剂)同源。	
*attire			服装，打扮。at-同ad去，tire同tier(层)
*dire			可怕的悲惨的。词源同dinosaur恐龙。
*inclement 		险恶的，狂风暴雨的。来自clement温和仁慈的，形容天气(和climate同源)the climate is clement.气候宜人。
*prehensile 		善于领会的，适于抓握的。来自prehens-抓住、理解。(prehension理解，抓住≈comprehension理解，包含)
tarry			等待逗留。
infirm			衰弱的不坚固的。来自firm坚固。
*leprosy			麻风病，腐败。来自leper麻风病患者，不愿接触的人受蔑视的人。
*arthritis			关节炎。arthr-关节，来自词根ar(连接)，-itis炎症,Inflammation.例如Conjunctivitis结膜炎，Nephritis肾炎(neph=nephelometry肾)，...
*metronome 		节拍器。和meter同源，来自希腊语metron测量。
encroach 			侵犯侵蚀。en-进入。来自crook钩子。同源词有crochet用钩针编织。
engraving 		版画。
socket			插座，穴，窝。I felt like my eyeballs would freeze in their sockets.	我觉得我的眼珠要冻结在眼窝里了。
whimsical			*幽默的。(异想天开的)	I'm sure that the chuckle coming out of her lips was meant to be whimsical. 	我敢肯定，那笑声是发自幽默感。
*nauseate   ['nɔzɪet]		v作呕，厌恶。 (和naught淘气同源。)
*slosh			n泥浆污水，v晃动搅拌，溅，泼。=slush.	more nauseating than all of the world's exotic brews sloshed together.	比世界上所有的异族饮料都要恶心。
*tundra 	  ['tʌndrə]		冻土地带，冻原，苔原。
oblivious 			健忘的，遗忘的。
formidable 		强大可怕的艰难令人敬畏的。词根formid-来自拉丁语formido恐惧。(for-完全,表强调)
acoustic 			声学的听觉的。(=acoustical)来自词根acoust.
shack 			棚屋。=shed
latch			门闩，插销。
flight 			*一段楼梯。	Reaching the shack, I unlatched the wooden door and opened it, revealing a hidden flight of wooden steps that led down a steep trench dug out of the earth.	到达窝棚的时候，我开了木门的锁，开门之后，里面露出了一段隐藏的木头台阶，一直通向地下挖出来的陡峭沟渠。
niche	[niʃ]		n.壁龛，(山体/悬崖上的)凹洞。	I hung the lantern from a metal hook implanted in the roof of the underground niche. 	我把油灯挂在地下室天花板垂下来的铁钩子上
barricade			路障，设路障阻碍。cade-是动词后缀。词源同barrel, 桶。该词来自于巴黎1588年的一次Huguenot暴动，大量的桶装满泥土，沙石等堆放在马路中间，堵塞主干道。而具体创造出该方法之人已不可考。
gravel 			碎石砂砾。(显然和grave坟墓同源。)-el小词后缀表示细碎的小块。词源来自grit(研磨)。	The floor was a sea of even gravel that crunched under my hooves.	整个地板是碎石的大海，在我蹄下咯吱作响。
*leyline			地脉。leylines of magic，魔法线。
altruism			利他主义。来自alter-异->他人。
throe			剧痛。
gulf=gulp			吞咽。是拟声词。(其中gulf引申为海湾、深渊。)
eerie 	['ɪərɪ]		可怕怪异的。
*pulsate			=pulse搏动悸动，beat，throb。
broadly			明显地，概括性地。(来自broad宽广的)
bear down		克服，压制。	I felt as though the weight of twenty thousand generations of moon phases was bearing down on my body. 	仿佛两万代月相的重量正压在我的身上。
mesmerize		迷住，施催眠术。来自19世纪奥地利医生Mesmer,因他发明了一种催眠术而得名。	mesmerizing cadence	优美的节奏。(mesmerizing令人着迷的优美的)
*alabaster 		雪花石膏，光洁雪白的。(埃及语。阿拉巴斯坦国名集取这美好含义)
tenacity			韧性，黏性，固执。	I skated across the alabaster surface of its melody with tenacity.	我坚定不移地滑过雪花石膏般的旋律表面。
nimble 			灵活的敏捷的，agile。
arsenal	['ɑrsənl]		兵工厂军械库。
thereof			=of there，它的，由此。	All citizens of the United States are ruled by the laws thereof.	美国的所有公民均须受国家法律之约束.	It was the death of all my music and the anthem thereof. 	这是我所有音乐的死亡终点，也是我所有音乐的赞美诗。
anthem			赞美歌。(在英语里特指国歌。)
devoid 			缺乏的。de-强调，完全的。void空的。即缺乏的。
dirge 			挽歌。来自direct引导。挽歌是引导亡灵的。	I tackled the dirge like a monk,pure in form and devoid of flare.	面对这首挽歌，我宛如一位虔诚的僧侣，心如止水，无喜无忧。
reaper			收割者->死神。
farce			闹剧笑剧。词源同fart放屁(滑稽意味)
solemnity (庄严)<-->solitude(孤独)	sole同源词，注意区别。
excruciate			折磨。ex-向外，crucial重要的关键的。(词根为cross十字。如cruciate十字型的。)这可能是十字架和刑罚绑定的引申。	The solemnity of the tune was excruciating to my ears.	这首曲子的森严肃穆在我耳中极度痛苦。
punctuation		标点符号。来自punctuate强调，加标点；词根为punct刺。(引申为精确、准时punctual；标点(刺->分开句子))
ravine			沟壑山谷。词源rapere(抓)，同rape强奸；raven掠夺；rapid快速的。rave咆哮。	I could have sworn the cellar had morphed into a bottomless ravine. 	我都发誓这地窖已经变成无底深渊了。
gobble			吞食，狼吞虎咽。来自gob嘴。
cord			*和chord有时混用(cord绳子->弦)。Was it the sound stones creating this deathly silence that gobbled up the vibrating edge of each cord? 	是音石创造了这种死寂，吞噬了每根琴弦振动的音波吗？	
navel 	 ['nevl]		中心点，肚脐。
intestine	 [ɪn'tɛstɪn]		肠子。内部的。int-=in在内部。-est存在。消化(digest)	
wheeze	 [wiz]		喘息。拟声词。
maw 			动物的胃。
entreat			请求，祈求。"to enter into negotiations, especially discuss or arrange peace terms;" 	en-使，treat处理。使对方处理->恳求。	 I entreated the walls and the walls buckled. 	我向着墙壁祈求，而它们却轰然倒塌。
deluge			洪水。de-向下，lug-冲洗喷流。词源同lava，flood。
sheen 			光泽，光辉。词源同shine。
penumbra 		半影。pen-=pene-几乎。	umbra词源同umbrella阴影。	Alone in the penumbra of all my hopes and horrors I cuddled that voice and I heard...	在我所有的希望之中，在我所有的恐惧之中，在希望和恐惧的阴影边缘，我孤独地紧抱着那个声音，我听到了……
*gazelle 			瞪羚
sprawl			蔓延，乱摊开。spread+crawl。	I look up from a sprawling assortment of textbooks and notes across my bed covers.	我从满床乱扔的课本和笔记上抬起头来。
scoop			勺子，掘。	“Oh shoot!” I scramble to scoop up all of my study materials and shove them into a turquoise saddlebag. 	“嗷，见鬼！”我尖叫一声，慌里慌张地把所有的学习材料都捡起来，塞进了绿松石色的鞍包里。
*turquoise    ['tɝkwɔɪz]	绿松石，蓝绿色。(直译为来自土耳其的石头，和turkish同源)
tonality 			音调。来自tone。
slack 			松弛松懈；松弛的松懈的。来自PIE*sleu无精打采的，词源同relax，slow。		I can't let myself slack off for even a second!	我一秒钟都不能放松！
groan			呻吟抱怨。拟声词。	 I linger in the middle of the stairs, groaning. “Don't tell me... What have I forgotten now?”	我在楼梯中间转悠着，无力地叹着气。“别告诉我……我又忘了啥？”
peck 			啄食，轻轻亲吻。来自pick变体，捡拾->啄。	 I dash over to give him a swift peck on the cheek. 	我冲过去在他脸上飞快地亲了一下。
*cantaloupe		哈密瓜🍈，甜瓜。 
jostle	 ['dʒɑsl]		推挤，撞，争夺。来自joust竞争厮打，-le表示反复。		The train car keeps jostling.	火车车厢一直那么拥挤。
scribble 			潦草写成的杂文，乱写。来自scribe(写下)。-le表反复。同源有describe描述(即de-表强调+scribe写)；script(脚本)	I scribble a few things in my notepad.	于是我在笔记本上潦草地记了些东西。
*Adagio 			柔板慢板。
mill			磨坊，搅拌磨细。
thatch			茅草，杂草。	I see apple trees, a windmill, thatched roofs, a bell tower, and more apple trees.	我看到苹果树，风车，茅草屋顶，钟塔，还有更多的苹果树。
muzzle 			枪口；动物的鼻口。和morsel(一口食物)同源
glisten			闪光闪耀。和gloss/glint同源。
bulge 			膨胀，使凸起。词源同ball，膨胀。	There is something weighing on her, and I think it's more than just the farm family's sweets forming a bulge in her belly. 	她好像有什么负担，估计应该不止是这个热情农家硬塞进她肚子里的那一大堆甜点什么的。
protege  ['prəuteʒei]	门徒，被保护者，门生，受提携的后进。来自protect保护。
charge			*冲锋。lead the charge  带头冲锋。
chomp			格格咬牙，切齿，大声地吃。同champ。拟声词。(不过注意champ有时是champion的简写)
*sarsaparilla		沙司汽水。
*shindig			盛大聚会。可能来自shin(胫骨->腿)+dig(挖->摇摆)-->跳舞💃。
*termite			白蚁。
*bellhop			信差，做杂活的服务生。(大腿上绑个铃铛??)
devilish			邪恶的->精力旺盛的、非常的。来自devil-ish。
stake			桩，股份，重大利益，下赌注。There's so much at stake!	这件事关系重大!
fruition			结果实->完成。	Things that have been set in motion long before history can remember will come into fruition.	有些未曾来得及记录在历史中的往事就要诞生出后果了！(set in motion--启动。)
get washed up over nothing  你有点不必要地焦虑过头了！	You're getting all washed up over nothing, Twilight.	你就别太激动啦，暮光。
brisk			轻快的凉爽的敏锐的。词源同break冲破->敏锐。
confetti 			五彩纸屑。来自confection糖果🍬。
comfit糖果,蜜饯。
confect糖果,蜜饯。
confection甜食,糕点。
其实这三个单词的词根构成都一样:一起+做,怎奈何有这麽多做的花样?可见英语不是一般的变态,而是特别变态。
get a lay of...	熟悉一下。这里的lay指overall的一个layout。		I should have gotten a lay of the land.	我本来应该先四处走走熟悉一下地方。
*helm 			舵，驾驶盘。有时也是helmet头盔的简写。
*onyx			玛瑙。
crescent 			新月。伊斯兰教标记，土耳其国徽。cresc-同creat，指(🌙)创造生长。
scrap			碎片。来自scrape(刮，擦，磨)的对词形式。来自PIE*sker砍切削，如share,shear,scrub.	
rupture			破裂。词源同rape，rip(撕扯)，rob
tatter			=rupture=rip，撕扯扯烂；n碎片。	I'm just a discarded scrap of refuse, cluttering the ruptured ground beside my fallen lyre and tattered saddlebag.	我只是一堆被抛弃的垃圾，散落在我倒下的七弦琴和破烂的马鞍包周围碎裂的土地上。
*flail			连枷，鞭挞，挣扎，猛击。	I flail.	我挣扎着，扑腾着。
delirious			精神错乱的。来自词根delir-，精神错乱。如delirium。	Dear Celestia, she's delirious.	噢塞拉斯蒂娅啊，她神志不清了。
seizure			n夺取占领没收-->疾病突发；来自seize夺取抓住。	Quick. I think she's going into a seizure or something!	赶快，她可能是失心疯发作了!
prod			刺，针，戳。来自pr-刺(prick)+rod(棒，惩罚，枝条)
HAYPOCRATES		希波克拉底
unto 			=to
churn			搅拌。	The village full of churning bodies circulates.	整个镇子里充满了载歌载舞的身影。(circulate,传播流通。)
snarl			咆哮怒骂。
bat away			轰走，驱赶击打。	I bat away a few ponies before they can grab some cupcakes and interrupt this little “meeting” of ours.	有几只小马还没过来取蛋糕打扰我们的“小小会议”，就被我粗暴地挥着蹄子轰走了。
take the cake		非常过分，过头过火了。	This sort of stuff takes the cake!
double take		n. 心不在焉后突然注意而恍然大悟。I do a double take. 	好一阵子，我才醒悟过来。
permeate			渗透弥漫。per-透过。meat-=mea-=meate，穿过。	It is still bearable, but the agony permeates everything.	总算是能忍受了，但痛苦却渗透了所有的一切。
pounce 			猛扑突袭。词源同puncture,punch.punct-针扎，戳刺。	 I pounce on the first pony I see in downtown.	我扑向我在镇中心看到的第一只小马。
*hyperventilating		上气不接下气。hyper-，高亢过度极端。
*whelp 			小狗幼兽;v下崽。
*degenerative 		退行性，拆词即可
pentition			n/v请愿，请愿书。
knead			揉揉。揉捏按摩。
scotch			苏格兰的；n苏格兰威士忌
demise			[正式]死亡。
*bushel			葡式耳，大概42L。[口]大量许多			
pebble 			卵石。
canvas 			帆布，油布，油画。来自cannabis大麻=hemp。	I gulped  and searched for answers in the blank canvas staring back at me.“Twilight...?”	我在面前那张茫然的面孔上寻找着答案。……暮光……？”
crud			渣滓，杂质，脏东西。可能来自curd凝乳，乳状物，凝结。
limb 			*树枝。	I'm a limb cut off from the tree, forever a lost element.	我是从树上砍落的孤枝，永远失落的元素。
palpitation		心悸。颤动。来自palpitate心悸发抖。词源同pulse。	 I try to speak, but all that comes out are breathy palpitations.	我试着说话，但每一次发出来的只是气喘吁吁的心悸声。
chronicle 			编年史。chronic时间->慢性的长期的。
trip			(旅游)*绊倒。这个词义来自trap的变形。
backwater 		回流，死水，闭塞的地方，不受外界或新思想影响的穷乡僻壤山沟沟。
asunder			adj/adv化为碎片的，分离的。来自sunder，v切开切断。	I want to rip her asunder.	我想把她撕碎了。
pitch			*沥青->漆黑。(音准,投掷)	 I flailed—soaking wet—rolling over leaves and grass in pitch-blackness.  我浑身湿透，在漆黑的叶和草上乱滚。  pitch-blackness，极黑，沥青一样。	Touch pitch, and you will be defiled. 	近朱者赤，近墨者黑。	defile污损弄脏，峡谷隘路。de-向下强调，file线，文件。
gnash	[næʃ]		咬牙切齿，咬。可能是拟声词。	 I gripped my skull and gnashed my teeth, plowing my muzzle through the damp earth. 	我死死抱着脑袋，咬着牙把脸埋在湿润的土壤里。
infernal 			地狱的，恶魔的。来自infra在下面的低的。
tendril 			卷须，蔓。	My limbs were the tendrils of a numb ghost.	我的四肢仿佛幽灵的卷须般麻木不仁。
flounder			（尤指在水中）挣扎踉跄蹒跚绊倒。I floundered for a hoof-hold.  我挣扎着支起蹄子。
femur			大腿骨，股骨。来自拉丁语femur大腿。	I  saw an endless sea of trees, all shining in the pale moonlight like bright femurs planted in the ground: just as sterile and lifeless.	我眼前只有一片无边无际的树海，苍白的月光下，所有的树木都像是插在地上的白骨一般亮着惨白的光。贫瘠，毫无生机。
sterile 			不育的贫瘠的无菌的不毛的。词源ster,固定坚固。词源同stern严厉坚定。
drip=drib≈drop，同源词，滴落。
subtlety			微妙，敏锐。来自sublet微妙的。let小词后缀，sub下/小。	In time you'll appreciate the beauty and subtlety of this language.	总有一天你会体会到这门语言的优美和微妙之处。	When I did, I didn't bother with subtlety.   我实在没有力气，顾不上讲究草草(生了火)。
agonizing 		痛苦难忍的。来自agony->agonize->agonizing
futile 			无用的不重要的。fu-流。付诸东流->无用。词源同fuel(燃料)，fuse(融合)，foundry(铸造)
migraine			偏头痛。mi来自hemi-半边的，cran头颅->graine。
relate to			有关联->帮助,理解。	Spike gazed away, as if guilty for not relating to this infernal unicorn's frustration.	Spike立刻移开了视线，好像因为无法帮上这只遭殃的沮丧独角兽的忙而非常内疚。
sovereign	    ['sɑvrən]	君主。至高无上的，有主权的最高统治权的，极好的。来自sove(super变形，地位高的)+reign统治。	Sovereign power will continue to lie with the Supreme People's Assembly.	最高统治权仍然掌握在最高人民会议手中。
意识到了吗？help it 其实是忍受的意思。“I'm just so cold,” I murmured. I couldn't help it. I didn't want to help it.	“我太冷了。”我喃喃自语，声音细不可闻。我实在是忍不住了，而我也没想去忍。
snap			*抱怨/严厉粗暴的话语。(突然折断/关上/拉断猛咬/噼啪声/突然的)
ensuing 			接着发生的。来自ensue追求;跟着发生。en-进入，-sue顺序，同sequence。	 What will ensue from this?	这事的结果将会怎样?		 His ensuing grin was braver than anything.他随后露出的笑容比任何事物都要勇敢。
*sappy hoopla		胡言乱语。
portion 			一部分，=part。是part的变形。
peruse	[pə'ruz]		仔细地读。per-完全的，use使用。比喻用法。	she murmured while perusing several scrolls mailed in from her homeland. 	她喃喃地回答，阅读着从家乡寄来的几封信。
*atrium			中庭，前厅，心房。词源同arson纵火。来自PIE*ater-，火。
nonchalant		冷淡的漠不关心的。non-无，非；chal热的。词源同calorie。ant形容词后缀。
poker face		扑克脸->面无表情。
*snare			陷阱圈套。词源同net网。也引申为
*jest			开玩笑。
forge			熔炉，锻造，前进。引申贬义"伪造。"	Something melted across her face, a sweet smile forged by a dozen memories all flashing across her blue eyes.	她脸上似乎有什么东西融化了，那双蓝眼睛里闪烁着无数回忆构成的甜蜜微笑。
*Nostalgia 		乡愁。
baffle			使困惑，使受挫。n挡板/困惑。	But their presence here truly baffles me...	可我实在困惑为何它们竟会在此处？
flippant			轻率的嘴碎的。=flip(蹦跳轻弹->无礼轻率的)
deem			视为。	 Experts deem it the most technically sophisticated tool ever found.专家们把它看作目前为止出土的技术最复杂的工具。
orthodox			正统的，传统的，惯常的。ortho-正统的,原。(orthogonal，正交的，直角的。orthonormal，标准正交的。)dox观念思想，(dogma教条，doctor医生。)
seclude			隔绝，分开，isolate。se-分开离开，-clude关闭(词源同close，conclude一起关闭结束->结束/决定/作结论，exclude向外关闭->排除在外)	such a secluded zebra。	这只隐居的斑马。
wondrous 		奇妙惊奇非常的。是wonder的形容词。
faraway 			遥远的，恍惚的。		I must solemnly admit my dismay, for I have been committed to work and not to play. Why else would I be working in a faraway land if not to seek the mysteries of the world so that I may understand?	不得不承认我十分沮丧，我一直在工作无暇迷茫。若非专注寻找世界奥妙，我何必来遥远国度繁忙？
rendition			提供呈现的东西->演奏，译文，提供。来自render。	Zecora squatted across from me, her face eager and bright, just as I began my rendition of a ritualistic chant that I had researched long ago.		泽蔻拉坐在我对面，脸上的表情热情而开朗。而我开始演奏一曲很久之前研究过的仪式用圣歌。
render			实施/提出/致使/呈现/表达。词源同surrender(在下方+提供->投降)	The Board had been slow to render its verdict.	董事会迟迟未能作出决定。
ritualistic 			仪式性的。来自ritual仪式。










