crucible		坩埚，严峻的考验。来源crock，瓦片，瓦罐(拟声词) 
sear		烤焦，干枯。 Are they the substance of all our attachments thrown into a searing crucible of mortal fear?
mistress 		女士，女霸主。I saw the fall of night like the mistress of death. 
threadbare	磨破磨损的衣衫褴褛的。(线头裸露)
skitter		飞掠而过，掠过水面。来自skit轻快地跑。Dreaming was a threadbare, skittering whisper。梦是微弱轻捷的耳语。
lucid		清晰透明头脑清醒。来自luc-，光。
whilst 		=while.书面异体字
epiphany		对事物真谛的顿悟，主显节。epi-在上，phan出现。(photo,phantasm错觉/幻想)
instrumental	*乐曲
permeate		弥漫，透过。per-通过。(permission).   -meate来自PIE*mei,改变,交换。(mutual) between that impermeable gap of sleeping and waking...
resurrect		使复活
dastard		懦弱的，懦夫。来自daze(迷惑眼花)和bastard都是骂人...。
emblem		象征。
flake		薄片。snowflake❄.
stunt		阻碍，阻止正常生长
jackass		公驴，蠢b
Dumpster		大型垃圾场，垃圾车。
mortar		研体，迫击炮，臼,用水泥砂浆结合涂抹。clear the mortal hole!!!!攻占掩体！！
bangalore	爆破筒，班加罗尔(印度中南部城市)
inert		惰性的，呆滞的，in-不，-ert灵巧，技术，同art。
be not THOU far from me, O lord.别远离我。

KIA		abbr. 阵亡（Killed in Action）
abeguile		欺骗，使着迷。(安抚。)阿比盖尔。
anguish		痛苦。
enfilade		纵向射击；容易被高处敌人射击地不利地带。stay outta this fucking enfilade! use the building!
defilade		遮蔽处。
coup  [ku]	政变.
altar		祭坛，圣坛。
cashew		腰果。
beak		鸟嘴，鹰钩鼻
janitor		看门人。同january，一月。
bagel		百吉饼。
handcuff		手铐。cuff，手铐，袖口。
prowl		徘徊潜行。
spank		打屁股，拍击(一般形容类似sm的手法)
plumage | plume [pluːm] | feather	plumage特指鸟类羽毛;plume比较文艺的羽毛说法;feather泛指(羽)毛。
camaraderie	n.友情.词源同comrade。
jubilant		喜气洋洋的。jubilate,欢呼。
patron		(赞助者)* [宗]守护神。
Schutzstaffel,SS	党卫军。为德文Schutz（护卫)与德文Staffel（团队、编群、队伍）的组合词，英文普遍简称为SS
convoy		车队。护卫，护卫队。con-强调，voy路。同way,via。
e-dict		法令公告。e-向外;dict说。
e-mul-sion		乳化剂。e-, 向外。-mul, 挤奶，词源同milk.
enamel		搪瓷。
ceramic [sɪ'ræmɪk]	陶瓷。=china
file		*锉刀
courteous		有礼貌的。来自court，宫廷。
char-ade[ʃə'rɑːd]	猜字谜，做戏，假象。来自char-字符。
ritual		仪式性的，仪式。=rite。
lice		虱子（louse 的复数）
stuffed		塞满的。stuff，东西，v塞满。
hose		软管。fire hose，消防水管。
come in handy	派上用场。
sullen		不高兴的，天气阴沉的。来自sole，寂寞而闷闷不乐。-en形容词后缀。
morph		图像平稳变换。补帧技术，变化。
caramel		焦糖。来自cane甘蔗(藤条/手杖)，-mel糖。鼻音字母n在m前流化成r，比如charm，germane(密切的)。
shuffle		拖着步子走，洗牌打乱。来自shove，挤，推，撞。
albeit 		conj.虽然，尽管。逆序缩写词，although it be.  Caramel said with a grin, albeit a grin that was already crumbling.焦糖带着微笑说,虽然那微笑已经有了裂纹。
clique		派系，小圈子。拟声词，模仿关门的声音，形成私党/阀/小团体。
solstice		至日。sol-太阳，st-站住停止(stand,stop)
bashful		羞怯的。bash猛击。
Egads!		int．天哪。
serenade[serə'neɪd]	小夜曲,情歌。来自serene [sɪ'riːn]，宁静的。He said, a gentleman that evening was going to serenade his mistress.他说, 当天晚上有一位先生向他的情人求爱.
ember		余烬，灰烬。
levitate		使升空，轻轻浮起。词源同lever，light。
fidget['fɪdʒɪt]	烦躁不安。
jolt		颤动摇晃。来自jitter抖动。jittery,紧张不安的，神经过敏的。He fidgeted, his limbs jolting with an jittery nature that rivaled the snapping embers of the burning pyre. 
somber		忧郁昏暗的。
burrow		挖掘探寻。来自bury埋葬。Caramel's face winced as if a horrible dagger was burrowing through him. 
grimace 		n. 鬼脸；怪相；痛苦的表情。来自grim咆哮。
in a hearbeat	在一瞬间做出毫不犹豫的决定。
*celery		芹菜。
stalk		杆子，茎。celery stalk,芹菜苗。
livestock		家畜。”活的股份“
resort		v. 求助于或诉诸某事物，采取某手段或方法应急或作为对策。My father have resorted to selling livestock, but even that isn't helping.   resort to，诉诸。
sage		圣贤，明智的。
clench		紧握，抓牢。是cling(坚持，紧贴)的变体。He clenched his eyes shut他紧紧闭上眼。
reverberation	反响，回声，echo。verb-动；verberation，打击(产生震动/声波)
woe		悲伤。感叹词。woeful，悲伤的。
scrunch		蜷缩，发出嘎吱声。拟声词。He glanced up at me with a scrunched face.他鼻子皱起来。
bard		吟游诗人。
sliver		梳毛，小薄片。来自辅音丛 sl-,砍，劈，分开，比较 slab,slip,slat,slit,slot.    There was still a sliver of crimson across the edge of the world. 天穹的边缘还有一丝紫红。
sore		疼痛的。sorry同源。
ecstasy		狂喜，灵魂出窍。≈euphoria。 ec=ex向外；st站。偏离原地，即灵魂出窍。
glee		快乐。
subtly  ['sʌtli]	微妙地。来自subtle。
concussion [kən'kʌʃ(ə)n]	冲击，震荡，脑震荡。
veil		面纱。来自拉丁语velum，膜，帆。velum[生]膜。
throe		剧痛。尤指分娩/临死。词源同throw。
predicament	情况，困境，窘境。predicate，断定为；谓语。pre-dict，预报，预测。pre前，dict说。 she was not only alone in her predicament, but she was cursed.
ostracize		v放逐。来自希腊民主社会的陶片/骨片放逐n.  ostracism，ost是骨头。
shriek		尖叫。
mettle		勇气，精神气概气质。来自metal金属的变体。
plea		恳求，辩解。词源同please。
startle		吓一跳，惊跳。start开始/跳动跳起，le表反复。
befit		对xxx适当。be fit to.   Such actions do not befit you.这种行为与你不相称啊！
repent		忏悔。pent-惩罚，如pain，punish，penitentiary，penalty
effigy		雕像。e-向外，fig形成，词源同figure，fiction。
trinket		饰品。来自trick把戏，-et小词后缀。
feat		功绩，壮举。来自词根fac-做，如fact，manufact。
hyster-ia		歇斯底里。来自hysterical歇斯底里的，-ia是疾病后缀。
faze		打扰，使狼狈。
bulwark 		堡垒。bul-同bole(树干)，wark=work工作。原指对木制船只所做的加固和防御工作。后指堡垒。
better nature	人性高尚善良的一面,善心，不是说更好的品质，这是个固定搭配。You could always try appealing to his better nature.你可以试图打动他的善心（好让他为希望工程捐点钱之类的）
smolder		焖烧，阴燃。来自smoke，只冒烟的焖烧阶段。
inferno		阴间地狱，无法控制的大火。infer=infra，在下面的(地狱)
within		(=with)   *看/听得见/够得着的。Every villager within view of the smoldering chaos ran to grab buckets of water and stop the inferno. 
conflagration	大火。con-强调，flag燃烧传播感染-->旗帜。flagrant，公然的，臭名昭著的
arson		纵火。		
practically 	(实际地)  *几乎；事实上
dismay		沮丧，失望。dis-不，-may力量。没有力量。--> 灰心沮丧。
profuse		丰富的，很多的，慷慨的。pro-向前，fuse流，涌。同fuse(熔化)，confuse。They apologized profusely to the pony。他们连连道歉。
hal-lucinate	产生幻觉。luci=luc，光。类比illusion幻觉。
transpire		发生。happen的更正式说法。spire火花(类比inspire)，
atrocity		暴行。
gossamer 	蛛丝-->薄纱。gos鹅。samer-是summer夏天变体。夏天出现形似鹅毛的东西，称为蛛丝。the final gossamer strand to her sanity had yet to be snapped.她脑内最后一根游丝般脆弱的理智还未挣断。
eon		永世万古。Entire galaxies have dissolved over the eons.浩瀚天穹在永世中消逝.形容绝望
tonic		补药神仙水。音译为奎宁水。
rupture		狂喜。来自rapt，全神贯注的，入迷的。词根同rob(抢劫)，抓住，抓取。
apathy		冷漠。a-没有，path感觉，感情。
encompass	包含。en-进入，compass包围，指南针。No living thing should face a reality like that, to be an island with no sea—only the perpetual blackness of apathy, encompassing. 
cessation		停止，中断。来自cease或cession(转让割让)，词根cede-走，离开。
lurch		倾斜，蹒跚。词源同lour(皱眉头)，lurk(潜伏，埋伏) She lurched through the streets like corpse.
masquerade	化妆乔装，化妆舞会。mask变形为masque。
oblivion 		遗忘；赦免。本意是拉丁语，涂抹。
oblivious		健忘的。
story		*楼层。   (ledge窗户边缘。)   standing on the fourth story ledge of town hall。她站在市政厅四楼的窗户边缘。
dishevel		使蓬乱，使毛发头发凌乱不堪。shevel来自法语cheveu头发。+dis(否定)	. In her eyes is the reflection of a hyperventilating unicorn with a disheveled mane.	在她眼中映出了我的倒影，一只鬃毛蓬乱，上气不接下气的独角兽。
hiccup		打嗝，抽噎。这是个拟声词 ['hɪkʌp]。驯龙高手里的小男孩。
brink 		边缘。来自break，分开，切开。  Her soul teetered upon the brink and threatened to pull her body along with it. 她的灵魂已经在窗边摇摇欲坠，似乎要将身体也一起拉下去。
spit		*发生口角，争吵(吐痰) she spat down at him, furious. 她愤怒地朝下面吼道。
gloss		光泽，注释；使有光泽。和glass，glow同源。
brunt		冲击，首当其冲，主要力量。可能是拟声词。
beleaguer  [bɪ'liːgə]	围攻。be-，around,围。leaguer，围攻，联盟(来自league)
in a matter of minutes	仅仅在几分钟内。
facade  [fə'sɑːd]	正面，外观。来自face。
blatant		公然地，喧嚣地。来自bleat羊咩咩叫。(拟声词)
audacity 		大胆，厚颜无耻。audacious,大胆的。
pest-ilence	瘟疫。尤指鼠疫。来自pest，害虫，讨厌的人。->pestis,鼠疫。
pest-ilent		致命有害的。
she had the blatant audacity to gallop across their lives and impart her pestilence upon them. 她这般突兀地四处穿梭，将自己的瘟疫强加于他们身上。
crib		婴儿床。来自cradle。也有抄袭的意思(这来源于于学生群体的俚语。)
flicker		闪烁摇曳。来自flick，摇动，轻轻拍打。来自辅音丛fl=bl，拍打，拟声词。同flip。ck，清脆。音
meager		贫乏的瘦的。Fustian can't disguise the author's meager plot.浮夸的文章掩饰不住这个作者的贫乏情节。
carol 		颂歌赞美诗，欢乐歌唱。词源同chorus。
felicity		幸福，快乐。来自fe吮吸。如female
erect		使树立，竖立，勃起。e-向外，-rect竖直。词源同correct,direct.
sizzle		火焰嘶嘶声。simply enjoy the sizzling bonfires erected before us now!享受眼前跃动的篝火吧。
frail		脆弱的，少女。同fragile。
falter ['fɔːltə]	蹒跚着走，支吾，颤抖。来自fold折叠。er表重复/小词。
glade		林中空地。，沼泽地。词源同glass，发光。因为在林中空地可以看到月光，不会那麽黑暗了。密林中明亮光线之地。
grove		小树林；果园。 "grove, copse, small wood"。来自group
replenish		补充，再装满。plen-，fill。-ish，使动词缀。词源同plenty。
ravage		毁坏破坏蹂躏。词源同rape。
dormant		休眠的。来自door，室内休眠。
swamp		沼泽，下沉。来自swan沼泽。
proximity		接近，邻域。来自proximate，最接近的。approximate，近似，粗略估计。
grotto		岩穴。
forlorn		被遗弃的,绝望孤独的。for-, 完全的。lorn, 失去，词源同lost。
stout		结实的，矮胖的。
shroud		n. 寿衣；覆盖物。v覆盖包裹(有死亡意义地)
bellow		大声喊叫。bell->bellow。拟声词。
relapse		故态复萌，再度坠落，旧病复发。lapse，失效，流逝。来自slip滑，引申为流逝失效。  a momentary lapse of concentration 走神儿
shrine		圣地，神殿。
larva		幼虫，幼体。A caterpillar is the larva of a butterfly. 毛虫是蝴蝶的幼体.
vanquish		征服，击败，战胜。来自拉丁语vincere,战胜，击败，词源同victory,convince.
trail off		逐渐消失。trail踪迹，踪迹没了。
pivot		绕轴旋转；adj枢轴的，关键的。
wry  [raɪ]		歪斜扭曲。词源同wring(拧)，wriggle(蠕动)。wri-，弯，转。
squat		蹲坐。he squatted down beside Wind Whistler.
purr		柔声说出，猫咪呼噜噜叫。(拟声词)“Mmmm...” She leaned in, nuzzled him, and purred deliciously into his ear, “Prove me wrong.”
bask		晒太阳，取暖。bath+sk。直译为给自己洗澡。sk=sui=self是反身格后缀。  busk卖自己，
etymology [,etɪ'mɒlədʒɪ]	词源。es-存在，同essence
strobe		闪光灯，电视机雪花闪烁，频闪的。Theville had become a strobing sensation of amber flame and rainbow explosions.  THE镇成了金橙闪烁与虹色光火的海洋。





