wield			使用. 同use, utilize. `Wield raw intellectual power. Deduce the world.`运用纯粹智力. 演绎整个世界.
lobe			脑, 肺的叶.
dissipate		驱赶, 耗散, 蔓延散开, 浪费. dis-分开, -sip扔. `The cold dissipates into your parietal lobe like a dissolved bullet.`寒冷蔓延进你的肺叶顶端, 就像一颗溶解的子弹.
parietal		[生物]腔壁的, 顶骨的.

malt			麦芽
limbic			边缘的.
anyssopelagic	深渊的. abyss深渊, pelagos海洋. pelagic远洋的.	
marinate		腌制. marin-海洋的, -ate动词.
bludgeon		强迫, 暴力逼迫. 来自blunt-钝器, -eon古英语中加强语气和力量感. 如dungeon; pigeon.
apprehension	忧虑/逮捕. ap-朝向,靠近. pre-向前; hend-同hand,抓住. 如comprehend理解.  `fear and apprehension...`
vie				争夺. 
consign			交付; 把xx置于(惩罚境地) con共同,sign标记.
retina			视网膜. retin-网. reticulate网状的.
flare			(火焰闪烁)*喇叭裤. flare-cut pants.
hunch			预感.
esprit de corps	[french]同舟共济. esprit呼吸,精神; de的,属于  corps身体->团队
overcast		多云,阴天.
satin			缎子.绸缎.
faucet			水龙头.(美式)	tap(英式)
rigor			僵硬, 严格.
mortis			[latin]死亡. 词源同mortal. rigor mortis[医]尸僵.
insinuate		暗示. 含沙射影地说.  in-进入; sinus弯曲(正弦sine)
cortex			大脑皮层. 皮质.
savoir-faire	[french]随机应变社交技巧. savior明智->知道, faire做. 懂得如黑做事.
briny			咸的. 来自brine盐水. /布莱恩./
seductive		迷人的. se-分离,离开. duc-带领. 同conduct(指挥,指导). 引诱分离->迷人的
succulent		多汁的. suc-汁液.同suck吸. -ulentus充满的.	
astute			聪明狡诈的. 
effectual		较少用, 同effective, 更专业一点. "this rendered it uneffectual!这样一来就失效了!"
volition		意志.
disdain			轻蔑. dis-否定, dain-词源同dignity, dignus-有价值的. 区别distain(玷污弄脏. 少用.)
taxidermy		动物标本,制标本技术. taxis-排列布置. derma-皮肤.
logistivs		物流,后勤.
bespectacled	戴眼镜的. spectacle[old]眼镜.
precinct		[ˈpriːsɪŋkt] 警区; 选区; 辖区.
rapport			融洽.密切关系. 
hurl			丢下, 猛扔, 掷地有声地愤怒地说出. if the windows came crashing down and the whole world descended upon you--this man would hurl himself in death' way to save you. You are sure of this--but why??
faction			派别. 小团体. 
retaliate		报复.	re-返还, talis同类. 词源同this, that. 即以牙还牙.
gratuitous		无端的, 无缘无故的. grat-感谢(同grace, gratitude). 原指感谢报答免费给予. 后词义贬义化, 无缘无故莫名其妙.
grudging		勉强, 吝啬的. 来自grudge, v.怨恨,妒忌, 不情愿;n.怨恨, 恶意.  拟声词. 类似grumble咕哝抱怨, grouse埋怨.		`he hates the union, but grudgingly recognizes its power over him--so he's directing his frustration at you instead. Retaliate!`
booth			卡座. 公用电话亭.
mess			(混乱)*n.食堂. mess hall, 餐厅包厢.
barrow			手推车. 来自bear, 承担承载.
pier			码头.=port=harbour.
tenement 		廉租公寓. 来自拉丁语 tenementum,领地，房子，所有物，来自 ten-,持有，握住，-ment,名词后缀。后 用于指廉租公寓，可能是来自幽默用法。参照英语名言“风能进，雨能进，国王不能进”。
inlet			入口, 小海湾.
livery			(liver-y肝病的); 制服涂装.`The bodywork is covered in blue and white livery bearing the number 57.`车身采用蓝白配色的涂装，并印有57号。
lollygag		虚度时光. loll v.懒洋洋地靠着.  gag, 吊儿郎当的行为.
tableau			[french]['tæbləʊ]生动的/戏剧性的静态画面,一幕. ≈scene, picture.
thaw			溶解.
suzerain		宗主国.
dismantle		拆除,废除. mantle斗篷. 原意脱下斗篷.
rhetoric		修辞,花言巧语.
janitor			门卫。 清洁工. jan-门. january一月.  `-itor`, 拉丁语中`执行某种动作的人`, 对应英语中的`-or,-er`.
macho			大男子主义
scrawny			瘦骨嶙峋的. scraw-, 瘦.
minutia			细枝末节. pl. minutiae. minute,小的,分钟.
jot				记载,记录. jotting down on the notebook.
polymer			化纤(因为是聚合物,poly-)
polyester		聚酯纤维. ester, 酯.

mush			伤感的话, 软,怯懦. Bullets will fly, and the coil(指肉体) is fleshy and mush and permeable.
constabulary	警察,警队. 来自constable, 警察/治安官.
torso			躯干.
asterisk		星号. aster-星星.
plecturm		琴拨， 拨片
sole			(唯一的)*鞋底.
aberration		奇怪, 失常, 脱离正轨.
prudent			严谨的.
autopsy			尸检. auto-自己的.












